cancel=abroger
prepare=préparer
recline=être couché
half=demi
hamlet=hameau
fifty=cinquante
tinkle=tinter
surgeon=chirurgien
abrupt=abrupt
nowadays=actuellement
halo=auréole
salary=appointements
pretend=prétexter
tea=thé
drunk=ivre
postman=facteur
pick=cueillir
rabbit=lapin
customs=douane
gloomy=morne
reproach=gronder
palladium=palladium
warrant=assurer
scanty=insuffisant
ten=dix
daring=audacieux
energy=énergie
conceal=cacher
solid=solide
meanwhile=dans l'intervalle
narrative=récit
coincide=coïncider
competent=compétent
circular=circulaire
require=avoir besoin de
scratch=gratter
housefly=mouche
moose=élan
click=claquer
willow=saule
size=ampleur
left=gauche
temper=durcir
eleven=onze
rejoice=être joyeux
amusing=amusant
talisman=amulette
abductor=abducteur
statute=statut
tickle=chatouiller
cardiac=cordial
object=chose
newspaper=gazette
accessible=abordable
flit=conter fleurette
hang=pendre
role=rôle
vengeance=revanche
cliff=falaise
roll=petit pain
suffice=suffire
turn=dévier
blond=blond
elect=adopter
miner=mineur
example=exemple
gold=or
result=provenir
opposition=opposition
padre=aumônier
golf=golfe
pier=débarcadère
same=identique
commission=commission
after=derrière
quiet=calme
staircase=escalier
connect=allier
nibble=ronger
rational=rationnel
hand=ouvrier
policy=politique
barricade=barricader
resume=abrégé
address=adresser
salt=saler
spiral=spirale
helium=hélium
blood=sang
straight=direct
the=à l'
halt=s'arrêter
sale=abattement
police=police
throw=jeter
exciting=captivant
stature=stature
obvious=évident
thank=remercier
regain=rattraper
surgery=chirurgie
confront=affronter
good=bon
undulate=onduler
empty=vide
faithful=fidèle
fiance=accordé
skeleton=squelette
tie=attacher
illiterate=analphabète
besides=d'ailleurs
tin=fer‐blanc
serious=considérable
disperse=dissiper
tip=bout
headlight=phare
laugh=rire
barman=barman
astrologer=astrologue
making=activité
adoration=adoration
cinder=cendre
fantasy=fantaisie
sagacious=intelligent
check=réprimer
relatives=proches
sand=arène
derrick=grue
grotto=grotte
cowardice=faiblesse
technics=technique
ascend=se soulever
drinkable=potable
harm=nuire
displeased=mécontent
rope=corde
aboriginal=aborigène
nobleman=noble
blotter=papier buvard
lilac=lilas
society=club
nowhere=nulle part
motive=lieu
ventilator=aérateur
envisage=contempler
romantic=romantique
root=racine
salami=salami
hard=difficile
hare=lièvre
spoil=abîmer
lend=emprunter
anatomist=anatomiste
roof=toit
chamois=chamois
pilot=pilote
ticket=billet
acceptor=accepteur
cheek=joue
citation=citation
umbrella=parapluie
approval=acclamation
raffle=loterie
multiple=multiple
aldehyde=aldéhyde
room=espace
better=meilleur
automate=automatiser
permit=permettre
well=bien
cancer=cancer
suitable=convenable
splash=barboter
taking=achat
airless=étouffant
fountain=fontaine
atlas=atlas
pile=amas
pioneer=pionnier
pill=pilule
chilly=froid
dummy=sucette
conjecture=conjecturer
myth=mythe
experiment=essai
flour=farine
rhinoceros=rhinocéros
apostle=apôtre
fierce=féroce
apiarist=apiculteur
block=se mettre en travers
hate=haïr
cordial=cordial
flow=couler
order=commander
aghast=stupéfait
caressing=tendre
consignee=destinataire
tangerine=mandarine
byte=byte
distant=loin
pike=brochet
timid=timide
hindmost=suivant
joystick=gouvernail
litre=litre
destine=destiner
reform=reformer
angular=anguleux
remit=abroger
anal=anal
podium=estrade
crazy=aberrant
razor=lame
coach=entraîner
homage=hommage
pink=œillet
successor=descendant
woman=femme
pine=pin
fuck=baiser
save=préserver
protection=garde
toe=doigt du pied
irony=ironie
matter=affaire
abscess=abcès
bandage=bandage
scrap=chiffon
ton=tonne
bikini=bikini
exactitude=exactitude
top=mutiler
too=aussi
have=avoir
adagio=adagio
shorts=culotte
tow=traîner
meadow=prairie
roast=griller
haul=tirer
adultery=adultère
quilt=coudre
famous=célèbre
contented=content
question=question
lover=amante
vinegar=vinaigre
spirit=esprit
duenna=accompagnatrice
quay=quai
reclaim=acquérir péniblement
allegory=allégorie
produce=produire
picture=image
allergic=allergique
cheat=tricher
ambrosia=ambroisie
regard=estime
cod=morue
witch=sorcière
rose=rose
anecdote=anecdote
thousand=mille
holly=houx
infect=infecter
klaxon=avertisseur
adverbial=adverbial
capital=capital
hostile=ennemi
spool=bobine
cow=vache
quack=charlatan
employee=employé
upon=de
lad=garçon
pray=prier
alder=aulne
crawl=ramper
gown=robe
identical=identique
plead=plaider
abject=abject
ambitious=ambitieux
towel=serviette
academic=académique
function=fonctionner
raise=élever
spoon=cuiller
west=occident
grisly=désagréable
quite=assez
lap=barboter
pipe=pipe
pitcher=cruche
puberty=adolescence
streetcar=tramway
tower=tour
traffic=circulation
pigeon=colombe
actress=actrice
comparison=comparaison
guilder=florin
law=droit
lay=coucher
anarchical=anarchique
patriot=patriote
pardon=excuser
plenty=abondance
adventure=aventure
anew=de nouveau
condition=condition
ceremony=cérémonie
improve=améliorer
mounting=montage
paperback=brochure
abdicate=abdiquer
try=peiner
hawk=autour
chicken=poulet
environs=abords
hastily=à la hâte
university=université
censure=critiquer
chatter=babiller
exterior=aspect
technique=technique
troop=troupe
scenery=paysage
sorrel=bai
wound=blesser
teacher=institutrice
haze=chicaner
muscle=muscle
generous=généreux
floor=étage
direction=direction
gnome=gnome
ammunition=munitions
wounded=blessé
alcoholic=alcoolique
bachelor=célibataire
casserole=casserole
cry=cri
inspector=inspecteur
opening=orifice
doctor=docteur
saliva=bave
industrial=industriel
inflate=hausser
pineapple=ananas
stable=ferme
harness=atteler
pillow=oreiller
grapple=attraper
respond=correspondre à
sketch=esquisser
sport=sport
tub=baquet
cluster=grappe
prey=proie
lieutenant=lieutenant
tug=tirer
concert=concert
pity=mal
absorb=disposer
supply=fournir
tup=bélier
uncertain=aléatoire
circulate=circuler
concern=importance
leg=jambe
incubate=couver
beautiful=beau
eventual=éventuel
mountain=mont
accuser=accusateur
let=laisser
state=affirmer
press=presse
worker=ouvrier
dough=pâte
element=élément
waterlily=nymphéa
night=nuit
pace=faire les cent pas
probable=vraisemblable
ballet=ballet
opposite=vis‐à‐vis
jackal=chacal
pack=paquet
each=à
cup=tasse
thirty=trente
armpit=aisselle
polite=courtois
workman=ouvrier
ardent=ardant
cut=faucher
probably=probablement
warrior=militaire
anaconda=anaconda
document=acte
mallet=maillet
battery=accu
two=deux
clay=argile
moment=instant
warmly=chaudement
promote=promouvoir
teat=mamelle
celery=céleri
tear=larme
attack=assaillir
humour=humeur
builder=bâtisseur
divorce=divorce
skinny=maigre
attach=appliquer
distribute=dispenser
kitchen=cuisine
shout=crier
ankle=cheville
situation=situation
think=être d'avis
thirst=soif
accused=accusé
absolution=absolution
lottery=loterie
team=équipe
shove=faire glisser
brooklet=ruisselet
claw=griffe
mongrel=hybride
torture=torture
mistress=maîtresse
paprika=paprika
freemason=franc‐maçon
prayer=prière
lyric=texte
speech=discours
watch=montre
clap=applaudir
purple=pourpre
quit=démissioner
albumen=albumen
urchin=bambin
pluck=cueillir
polish=polir
cabinet=armoire
thing=chose
fashion=mode
insurance=assurance
surely=d'abord
dazzle=aveugler
principle=principe
thigh=cuisse
lid=couverture
lie=être couché
carnation=œillet
fumy=délétère
source=fontaine
smell=flairer
domestic=aborigène
initiate=prendre l'initiative
lip=lèvre
separation=abandon
fume=exhalaison
shoot=tirer
accusal=accusation
abbess=abbesse
stencil=modèle
acquired=appris
manna=manne
radiate=rayonner
actual=effectif
chest=poitrine
glass=verre
tension=tension
chess=échec
reflection=reflet
ballad=ballade
prosecute=poursuivre
widely=largement
gooseberry=groseille
doubt=douter
jacket=veste
merit=mériter
develop=entraîner des conséquences
ampere=ampère
privileged=privilégié
mockery=simulacre
district=arrondissement
overall=total
fixed=fixe
page=page
aubergine=aubergine
full=complet
pepper=poivre
destiny=destination
away=loin
memory=mémoire
blister=ampoule
scientist=homme de science
contort=tordre
mica=mica
wheezy=asthmatique
pimple=bouton
house=maison
agnostic=agnostique
painful=pénible
beefsteak=bifteck
convention=congrès
pail=seau
antiseptic=antiseptique
harvest=récolter
pain=douleur
calcium=calcium
suspicion=méfiance
purchase=achat
shore=bord
start=activer
supper=dîner
pair=apparier
chlorine=chlore
manage=administrer
equal=égal
canker=cancer
marvel=s'étonner
fund=fonds
gravity=gravitation
reprove=gronder
recipient=destinataire
knapsack=sac tyrolien
short=court
thereabout=alentour
cauldron=chaudron
replete=rassasié
funk=peureux
finance=finance
studio=atelier
louse=pou
cabbage=chou
funnel=entonnoir
palm=paume
regulate=régler
ninety=quatre‐vingt‐dix
facade=façade
three=trois
childbed=lit d'accouchement
climb=gravir
eaglet=aiglon
ordeal=désolation
twitter=gazouiller
truncate=mutiler
season=saison
payment=réglement
attain=acquérir
enter=introduire
gallery=galerie
pale=pâle
tenant=locataire
deputy=député
anathema=anathème
destroy=abîmer
hostage=otage
inlet=fiord
mythology=mythologie
prudish=bégueule
coast=bord
provide=munir
yarrow=achillée
athletic=athlétique
remissness=négligence
abjure=abjurer
falcon=faucon
bright=luisant
consume=consommer
dome=voûte
accidental=accidentel
unknown=ignoré
glasses=lunettes
fuse=mèche
computer=ordinateur
premium=prix
wholesale=en gros
frivolous=frivole
low=abject
periwinkle=pervenche
assure=assurer
pretext=prétexte
prop=appui
anabaptism=anabaptisme
consult=consulter
solidarity=solidarité
motionless=au repos
wealth=richesse
means=instrument
hectolitre=hectolitre
wallet=porte‐monnaie
doll=guignol
centre=centre
baboon=babouin
orphan=orphelin
adversary=adversaire
postulate=demander
eternal=éternel
absurdity=absurdité
fellow=ensemble
fetch=amener
barely=à peine
clip=couper avec des ciseaux
door=porte
oasis=oasis
quick=prompt
alliance=alliance
speedy=prochain
dad=papa
friendly=affable
possession=possession
tell=dire
irrigate=abreuver
silken=soyeux
husband=époux
cyclone=cyclone
merry=gai
bloom=fleur
zone=zone
affair=affaire
majesty=majesté
day=jour
orthodox=orthodoxe
accustomed=accoutumé
poseur=faiseur d'embarras
apostolate=apostolat
banana=banane
hornbeam=charme
obtain=acquérir
adept=adepte
curiosity=curiosité
harrow=herser
repute=réputation
anus=anus
island=île
minutes=compte‐rendu
liter=litre
particular=particulier
water=aquatique
pause=pause
rainbow=arc‐en‐ciel
horoscope=horoscope
countless=incalculable
instructor=instituteur
fervor=ferveur
ample=ample
fetter=chaîne
gibbon=gibbon
salesman=marchand
galosh=galoche
entertain=recevoir des visiteurs
tent=tente
titanium=titane
gasolene=essence
part=part
diarrhoea=diarrhée
elsewhere=ailleurs
jealousy=envie
paddle=barboter
penetrate=entrer
bike=bécane
clod=boule
principal=principal
inducement=lieu
east=est
somber=maussade
resound=résonner
sixteen=seize
specimen=spécimen
restraints=bride
psychic=psychique
overtone=harmonique
park=garer
caesium=césium
revenge=revanche
actuality=réalité
subscribe=s'abonner
villager=villageois
absolutism=absolutisme
chauffeur=chauffeur
tongs=pinces
aristocrat=aristo
colleague=collègue
diamond=diamant
codfish=morue
confession=aveu
someone=un
third=tiers
build=bâtir
circumflex=accent circonflexe
gratitude=gratitude
earn=gagner
earl=comte
wireless=radio
further=plus loin
apartment=appartement
fitting=convenable
tolerate=tolérer
stack=accumuler
anemone=anémone
banjo=banjo
resent=s'indigner de
instigate=inciter
mutually=se
azimuth=azimut
compassion=apitoiement
ambiguous=ambigu
den=nid
parliament=parlement
asylum=abri
avidity=avidité
path=chemin
crack=craquer
bind=relier
pate=tête
acoustics=acoustique
angelic=angélique
dew=rosée
record=disque
asthmatic=asthmatique
adulterate=diluer
cube=cube
railway=chemin de fer
gadfly=taon
servitude=servage
bunker=abri
pass=permission
nineteen=dix‐neuf
past=passé
grate=grincer
mild=doux
mourning=deuil
shock=secouer
bilk=mystifier
milk=lait
strew=joncher
bill=bec
pancake=crêpe
easy=facile
acrid=acerbe
bile=amer
buyer=acheteur
clog=boucher
jester=arlequin
mill=usine
bucket=seau
smear=enduire
adult=majeur
attitude=attitude
relative=parente
average=moyenne
compare=comparer
radish=radis
mint=menthe
adoption=adoption
airman=aviateur
grasp=agripper
journal=journal
dove=colombe
grass=herbe
brag=faire le malin
hotel=hôtel
term=terme
volcano=volcan
rigid=raide
mine=mine
mind=esprit
business=affaire
advent=avent
apartheid=apartheid
adjoining=adjacent
partly=en partie
possible=possible
right=droit
chestnut=châtaigne
sturgeon=esturgeon
krypton=krypton
stage=tenue
balsam=balsamine
grumble=grogner
borrow=emprunter
lye=lessive
maximum=maximum
showcase=vitrine
polyp=pieuvre
waiter=garçon
desert=désert
under=sous
wainscot=lambris
quarter=quartier
die=décéder
fragrant=aromatique
radium=radium
dialect=dialecte
dig=creuser
pulverize=moudre
stocking=bas
dim=obscur
emergency=crise
impel=inciter
dip=tremper
adder=couleuvre
besiege=assièger
cheated=déçu
sixtieth=soixantième
down=duvet
faculty=faculté
wretched=misérable
habit=coutume
passport=passeport
glamor=gloire
bird=oiseau
bracket=parenthèse
club=club
legal=légitime
meteorite=aérolithe
cuff=manchette
highway=chaussée
radius=rayon
lunacy=aberration
signal=signaler
possibly=peut‐être
parcel=paquet
journey=voyage
test=examen
overground=aérien
finally=enfin
thereafter=après
varied=divers
conviction=conviction
grape=raisin
strap=courroie
aromatic=aromatique
brown=brun
straw=paille
brat=bambin
hideous=abject
sermon=sermon
feast=banqueter
sodium=sodium
acceptance=abord
month=mois
petrol=essence
learnt=appris
paradise=paradis
tackle=aborder
nude=nu
chuck=caresser
pawn=emprunter sur gages
distract=distraire
influenza=grippe
locust=criquet
occasion=fois
loan=emprunter
squeeze=appuyer en écrasant
poplar=peuplier
vegetate=végéter
rather=une certaine quantité
back=dos
title=intitulé
whore=fille
mist=brouillard
miss=manquer
pound=broyer
load=charger
aqueduct=aqueduc
bite=mordre
ferry=bac
rudder=gouvernail
ignore=bouder
company=compagnie
loaf=pain
nuclear=nucléaire
applaud=acclamer
poetry=poésie
prince=prince
arrogant=arrogant
relax=se relâcher
custom=coutume
length=longueur
priest=abbé
abode=domicile
advert=surveiller
permission=autorisation
grand=grandiose
raccoon=raton laveur
blackberry=mûre sauvage
beach=plage
faction=parti
inherit=hériter
interpret=interpréter
universe=univers
baby=bébé
blanket=couverture
adverb=adverbe
frigid=froid
cambric=batiste
discount=rabais
construct=bâtir
convert=convertir
thirteenth=treizième
attempt=se démener
thick=dense
relish=se délecter
airdrome=aérodrome
stale=rassis
uterus=utérus
balance=reliquat
stalk=chaume
cigar=cigare
lock=écluse
loch=fiord
quinsy=angine
text=texte
usually=ordinairement
whereas=durant
kindness=amabilité
fear=angoisse
adoptive=adoptif
adversity=abaissement
cookie=biscuit
hyaena=hyène
printer=imprimeur
ampersand=perluète
torrent=flot
statue=statue
sense=sens
stall=écurie
curry=panser
menace=gronder
field=champ
contents=contenu
curse=blasphémer
baseball=base‐ball
interval=intervalle
doe=biche
mitten=gant
dog=chien
mite=acarien
renown=distinction
amputation=amputation
tussle=se bagarrer
upset=stupéfait
crayfish=écrevisse
goodbye=adieu
dot=point
skin=fourrure
stamp=timbre
tailor=couturière
albatross=albatros
cleanse=affinier
stamped=affranchi
inflated=afecté
stingray=raie
mention=mentionner
mad=aberrant
government=gouvernement
cult=culte
stream=courant
sewer=cloaque
grudge=rancune
herald=héraut
mam=maman
nurse=soigner
accumulate=accumuler
strop=cuir à rasoir
brim=bord
crime=crime
dwarf=nain
man=être humain
stand=échoppe
map=carte
surround=entourer
twenty=vingt
alcove=alcôve
pavement=pavé
cigarette=cigarette
maw=gouffre
intone=entonner
assimilate=assimiler
bless=bénir
zealous=fervent
airsick=ayant le mal de l'air
aluminium=aluminium
spectacles=lunettes
incest=inceste
mail=courrier
subject=sujet
trombone=trombone
use=appliquer
feel=tâter
main=principal
sadness=affliction
bagasse=bagasse
strip=bande
cunt=chatte
continuous=continuel
grain=grain
maid=domestique
residence=domicile
oxygen=oxygène
intensive=intense
terrible=affreux
phosphorus=phosphore
waste=dissiper
ideal=idéal
vagina=vagin
bindweed=liseron
daybreak=aube
broom=balai
dry=sec
pressure=impulsion
streak=raie
paralyse=paralyser
feed=alimenter
staid=sérieux
originate=provenir
directions=instruction
null=zéro
compass=boussole
antidote=antidote
background=arrière‐plan
stodgy=maussade
bumper=pare‐chocs
wrangle=se disputer
handsome=beau
mystify=mystifier
stair=marche
blend=mélanger
presage=augure
conceive=concevoir
nonsense=absurdité
stain=salir
breath=haleine
ball=bal
napkin=serviette
repeat=redire
bald=chauve
paradox=paradoxe
loin=lombes
make=construire
rebuke=repousser
barley=orge
thread=fil
exactly=à l'heure
admittance=abord
structure=structure
fright=anxiété
masculine=mâle
orange=orange
stake=pieu
witness=témoin
aerogramme=aérogramme
racoon=raton laveur
ripen=mûrir
conform=concorder
backpack=sac tyrolien
bake=faire cuire au four
authentic=authentique
biscuit=biscuit
threat=menace
breast=poitrine
pumpkin=potiron
invention=invention
mercy=compassion
tunny=thon
curl=coiffer
inform=apprendre à
depend=dépendre
about=concernant
untidy=ébouriffé
cure=guérir
sorrow=abattement
danger=danger
patch=rapiécer
bank=banque
character=caractère
abashment=embarras
brow=sourcil
meaning=dessein
rostrum=tribune
above=au‐dessus de
drawing=dessin
stick=s'agglutiner
band=bande
orbit=orbite
watchmaker=horloger
comprise=contenir
height=altitude
moderate=abordable
invent=inventer
wonderful=merveilleux
execute=exécuter
balm=baume
benefit=avantage
flood=afflux
quality=propriété
decayed=caduc
miller=meunier
pillar=colonne
afresh=de nouveau
unique=unique
animal=animal
sincere=sincère
sober=sobre
gunner=artilleur
male=mâle
ministry=ministère
spinster=célibataire
expel=renvoyer
seizure=apoplexie
shelter=abri
examine=examiner
outset=début
alderman=adjoint au maire
industry=application
believe=croire
long=long
augment=accroître
remember=retenir
cedar=cèdre
into=à
profane=violer
butterfly=papillon
nought=zéro
arbitrator=arbitre
womb=utérus
mix=mélanger
acquit=absoudre
dirty=sale
stiff=raide
atrocity=abomination
bother=déranger
expression=locution
idiotic=stupide
middle=intermédiaire
prosper=prospérer
rudiments=abc
star=astral
though=quoique
wolf=loup
appeal=faire appel
many=nombreux
swamp=marais
abscond=s'enfuir
humus=humus
everyday=vulgaire
stay=séjour
dedicate=consacrer
appear=paraître
dye=couleur
extensive=ample
repelling=affreux
definitely=absolument
stab=piquer
monotonous=monotone
inspire=dicter
paintbrush=pinceau
progress=avancer
geometry=géométrie
glide=planer
cuss=blasphémer
open=ouvrir
devote=consacrer
agent=agent
berry=baie
treat=guérir
wool=laine
abortion=avortement
salvation=salut
bishop=évêque
grapevine=vigne
wholly=complètement
invest=investir
rapid=prompt
project=projeter une image
seven=sept
aberrant=aberrant
arena=arène
atelier=atelier
tread=faire les cent pas
whisky=whisky
barn=baraque
swiftly=rapidement
bark=écorce
loop=maille
greedy=avide
tobacco=tabac
wood=bois
bare=nu
bard=barde
abrogate=abolir
sidewalk=trottoir
crane=grue
formidable=extraordinaire
surprise=surprendre
abound=abonder
suitcase=valise
beard=barbe
murderer=meurtrier
underpants=caleçon
lobster=homard
gardener=jardinier
amphora=amphore
look=avoir l'air de
darken=foncer
dense=dense
discrete=discret
grounds=terrain
temperate=sobre
scar=balafre
abort=faireavorter
nuts=aberrant
sergeant=sergent
converse=intervenir
forefather=ancêtre
farewell=adieu
allow=laisser
alloy=alliage
knock=frapper
mast=mât
lord=monsieur
mass=amas
proper=convenable
amethyst=améthyste
beast=animal
muzzle=muselière
poisonous=venimeux
vegetable=légume
bitter=âcre
bast=liber
speed=hâte
auction=vente aux enchères
gesture=geste
apple=pomme
admit=admettre
common=commun
interest=intéresser
urgency=impulsion
twig=rameau
bath=baignoire
prologue=prologue
twin=jumeau
chaste=chaste
mask=masque
ungrateful=ingrat
patrol=reconnaissance
canary=canari
patron=protecteur
cubic=cubain
barbarian=barbare
apply=appliquer
stew=ragoût
recently=dernièrement
overlook=omettre
incredible=invraisemblable
mammy=maman
bedroom=chambre à coucher
cello=violoncelle
seagull=mouette
arabesque=arabesque
bass=perche
money=argent
attic=mansarde
healthy=sain
catering=ravitaillement
abacus=abaque
avalanche=avalanche
formula=formule
agar=agar‐agar
step=faire les cent pas
revolt=se révolter
mark=marquer
tribute=tribut
base=baser
stem=tige
oblique=oblique
gargle=rincer
mechanic=mécanicien
mom=maman
whole=entier
revolution=révolution
relation=abord
loss=perte
reliable=sûr
elevator=ascenseur
humor=humour
relate=conter
fern=fougère
mow=faucher
trifling=mineur
obstacle=obstacle
quince=coing
hazelnut=noisette
still=encore
worm=ver
work=fonctionner
lose=perdre
vat=baquet
anthology=anthologie
toward=à
rickety=caduc
courier=courrier
among=au milieu de
convince=convaincre
marigold=calendula
mate=s'accoupler
missionary=missionnaire
viper=couleuvre
terminate=cesser
nymph=nymphe
fertilize=amender
word=mot
theory=théorie
bawdy=bordel
love=aimer
flock=troupeau
extension=suffixe
internal=intérieur
signature=signature
tongue=langue
architect=architecte
churn=baratter
excise=droit de régie
forehead=front
enjoy=être joyeux
astrology=astrologie
foundation=fondation
secret=arcane
caress=caresser
slave=esclave
across=en largeur
naturally=bien sûr
falsify=falsifier
mortgage=hypothèque
ear=oreille
verify=surveiller
baldachin=baldaquin
excursion=excursion
inaugurate=inaugurer
academy=académie
spruce=épicéa
loud=haut
reward=récompenser
include=contenir
gusto=vigueur
repent=se repentir
swallow=avaler
aged=âgé
nucleus=centre
sperm=semence
sting=piquer
haste=hâte
juice=jus
gathering=réunion
godfather=parrain
buckle=boucle de vêtement
degenerate=s'abâtardir
opinion=avis
altogether=tout
monastery=couvent
soldier=soldat
sleeve=manche
censor=censurer
stir=affecter
insult=insulter
escort=accompagnement
voice=voix
avarice=avarice
appal=abasourdir
butcher=abattre
threshold=seuil
inebriety=ivresse
aeronaut=aéronaute
axis=axe
float=flotter
basketball=basket‐ball
negligent=négligent
defendant=accusé
desolate=morne
olive=olive
coarse=grossier
evade=éviter
alley=ruelle
hunter=chasseur
suckle=allaiter
discover=découvrir
midday=midi
imply=impliquer
offset=distance
aberration=erreur
vex=chagriner
capture=attraper
excite=exciter
partridge=perdrix
cavity=creux
coward=peureux
thrush=grive
recruit=recruter
thrust=pousser
mud=boue
commence=aborder
abolition=abolition
chunk=boule
winter=hiver
insure=assurer
bombard=bombarder
elder=sureau
eel=anguille
asteroid=astéroïde
platform=tenue
typeset=composer
spend=dépenser
axle=axe
petulant=maussade
agonize=agoniser
martyr=martyre
grave=tombe
advantage=avantage
assistant=adjoint
toad=crapaud
telegram=télégramme
chisel=buriner
summery=abrégé
ultimately=enfin
command=commandement
jack=bambin
compulsory=obligatoire
abortive=inutile
dessert=dessert
swarm=fourmiller
anticipate=anticiper
quietness=repos
gravy=sauce
temple=tempe
fabricate=fabriquer
landscape=paysage
perfection=perfection
seduce=détourner
temporary=temporaire
egg=œuf
expertness=adresse
year=an
thimble=dé à coudre
awful=abject
saxophone=saxophone
branch=branche
handy=commode
urge=inciter
slab=plaque
anguish=angoisse
chimera=chimère
counsellor=conseilleur
music=musique
waistline=taille
gramme=gramme
absent=absent
empire=empire
neat=net
because=attendu que
near=à
silence=repos
educate=éduquer
hypnotize=hypnotiser
moving=attendrissant
fairy=fée
agreement=accord
aflame=ardant
agreeable=agréable
mayor=maire
oscillate=osciller
merchant=commerçant
economy=économie
ailment=infirmité
community=commune
packet=paquet
arbutus=arbousier
cocoa=cacao
bronze=airain
folder=chemise
orchard=verger
stop=halte
flirt=conter fleurette
guess=deviner
calamus=calame
science=science
agreeably=agréablement
detain=réprimer
ragout=ragoût
guest=convive
notch=encoche
detail=détail
prudence=précaution
stow=serrer
forest=bois
cede=abandonner
eloquent=éloquent
sleep=dormir
agog=curieux
crumb=miette
refuse=refuser
columbine=ancolie
boldness=audace
behavior=procédé
musician=musicien
agreed=çava
annotation=note
sweep=balayer
descend=s'abaisser
flavour=arôme
fourteenth=quatorzième
slay=abattre
learn=apprendre
mechanics=mécanique
dreary=désert
neck=col
logical=logique
descent=descente
weird=bizarre
aperture=orifice
ridiculous=ridicule
refute=rejeter
severe=austère
monopolize=accaparer
emerge=paraître
lease=affermer
exploit=exploiter
sweet=doux
brandy=eau‐de‐vie
eager=avide
republic=république
communion=communion
errand=commission
entangle=empêtrer
garnish=garnir
official=oficiel
repellent=affreux
fling=agiter
narrate=conter
spring=émaner
autonomy=autonomie
shack=baraque
leave=partir
serpent=serpent
female=femelle
kindle=allumer
melon=melon
lavender=lavande
mayhap=peut‐être
artillery=artillerie
elf=lutin
faint=faible
surrender=abandon
minister=ministre
cruel=atroce
elk=élan
need=avoir besoin de
elm=orme
shade=nuance
often=beaucoup
gather=déduire
jail=prison
shoemaker=cordonnier
insist=insister
typewriter=machine à écrire
volume=volume
flint=silex
hardly=à peine
lasting=permanent
useful=utile
cynical=cynique
ventilate=aérer
private=privé
baggage=bagage
arrivals=fourniture
companion=camarade
backside=derrière
ride=chevaucher
calamity=fléau
accomplish=aboutir
engine=locomotive
medal=médaille
linen=toile
end=cesser
stroller=promeneur
satellite=satellite
bullet=balle
illuminate=illuminer
lizard=lézard
delirium=transport
forty=quarante
vow=vœu
cipher=chiffre
mistake=erreur
aplomb=aplomb
cockroach=blatte
flounder=se débattre
attacker=attaquant
rich=riche
chiefly=principalement
coquettish=coquet
rice=riz
praise=glorifier
slippery=glissant
forum=forum
scissors=ciseaux
special=particulier
horizon=horizon
airplane=aéroplane
stinginess=avarice
sweat=transpirer
betray=trahir
calmness=repos
acacia=acacia
pronounce=prononcer
family=famille
swear=blasphémer
abscissa=abscisse
shaft=puits de mine
atmosphere=atmosphère
gift=cadeau
decorate=décorer
education=instruction
occupation=métier
release=dégager
abiding=permanent
bookseller=libraire
moral=moral
aspire=aspirer
gradually=de proche en proche
penthouse=abri
archivist=archiviste
burdensome=lourd
explode=exploser
brave=brave
narrow=étroit
ague=fièvre
bastion=bastion
judge=juger
abrasive=perçant
darkness=obscurité
abominate=abhorrer
defile=col
manipulate=manier
similar=pareil
shape=former
seventy=soixante‐dix
relevance=à‐propos
gravel=gravier
leopard=léopard
driver=chauffeur
compose=se résoudre à
baobab=baobab
giraffe=girafe
charming=charmant
coyote=coyote
roller=cylindre
singer=chanteuse
tone=ton
optimism=optimisme
against=contre
shaggy=velu
cell=cachot
holiday=jour férié
swell=gonfler
barrack=baraque
crude=brut
gendarme=gendarme
valid=valable
withstand=affronter
encourage=inciter
albino=albino
era=époque
morality=vertu
potato=pomme de terre
administer=administrer
share=action
umpire=arbitre
obstinate=obstiné
shark=requin
snowflake=flocon de neige
err=se tromper
television=télévision
tomb=tombe
atavism=atavisme
untroubled=serein
cession=abandon
chairman=président
climber=alpiniste
storey=étage
sharp=coupant
unripe=prématuré
awfully=affreusement
slip=glisser
species=espèce
anchor=ancre
firing=tir
hectometre=hectomètre
logic=logique
spinach=épinard
shake=secouer
honor=honorer
spice=assaisonner
artichoke=artichaut
mores=coutume
autonomous=autonome
aerial=aérien
naked=nu
vibration=frisson
trial=désolation
furlough=permission
admiring=admiratif
undertake=entreprendre
bridle=réprimer
indigenous=autochtone
bureau=bureau
moist=humide
net=net
cable=câble
nasty=antipathique
intense=intense
new=nouveau
frolicsome=malin
charlatan=charlatan
below=dessous
juggle=jongler
musty=moisi
woods=bois
acoustic=acoustique
estate=bien
brass=laiton
tool=instrument
followers=adhérents
foretell=prédire
yell=clamer
abseil=descendre en rappel
greediness=avidité
tribe=tribu
activate=activer
amusement=amusement
boundary=frontière
shame=pouah
mandate=mandat
rill=ruisselet
xylophone=xylophone
enigma=énigme
regal=royal
respective=respectif
slot=cannelure
trick=artifice
around=autour de
accidence=hasard
bakelite=bakélite
harden=durcir
gill=branchie
vodka=vodka
tousle=hérisser
define=définer
dictate=dicter
memorize=apprendre par cœur
raincoat=imperméable
frontier=frontière
antelope=antilope
neon=néon
remiss=négligent
manifest=manifester
buffalo=bison
seaweed=algue
drawer=tiroir
rabies=rage
adjacent=adjacent
gild=dorer
politeness=politesse
transport=reporter
pencil=crayon
autism=autisme
caller=visiteur
adroit=adroit
chord=accord
whisper=chuchoter
appetite=appétit
needle=aiguille
strategy=stratégie
remainder=reste
risky=périlleux
axiom=axiome
territory=territoire
summon=appeler
flare=ondoyer
ring=anneau
farther=plus loin
maintain=conserver
couch=canapé
echo=écho
frolic=malin
bargain=marchander
cheese=fromage
accusation=accusation
nip=apéritif
pivot=pivot
shoulder=accotement
dance=bal
cheers=à la vôtre
fully=complètement
pearl=perle
phonograph=phonographe
diminutive=petit
aphasia=aphasie
waver=barguigner
remain=rester en arrière
allergy=allergie
amaze=étonner
congenital=inné
eye=œil
envelope=enveloppe
himself=même
dictionary=dictionnaire
mystery=mystère
slow=lent
deposit=déposer
angler=pêcheur à la ligne
rotten=mauvais
skillful=adroit
continent=continent
mattress=matelas
mosque=mosquée
maybe=peut‐être
needlework=couture
another=autre
guarantee=assurer
enemy=ennemi
recommend=recommander
bairn=enfant
waterfall=cascade
beverage=boisson
aspirin=aspirine
ripe=fait
insane=aberrant
mournful=morne
attribute=attribut
magician=sorcier
cemetery=cimetière
heron=héron
affliction=désolation
jaws=gouffre
triumph=triomphe
horror=abomination
poison=poison
gram=gramme
suffocate=étouffer
black=brun
arouse=réveiller
bauxite=bauxite
riot=bagarre
nest=faire son nid
fortunate=heureux
supporter=adhérent
persuade=convaincre
boring=maussade
such=autant
classic=classique
embellish=embellir
marten=marte
absolute=absolu
gossip=cancaner
describe=décrire
grab=agripper
suck=sucer
antecedent=précédent
wealthy=riche
foam=écume
pettish=maussade
genuinely=en réalité
dwell=demeurer
briefs=slip
boast=faire le malin
slut=roulure
research=recherche
landlady=aubergiste
provost=maire
white=blanc
furniture=mobilier
grapefruit=pamplemousse
stripe=bande
huge=formidable
menacing=sinistre
acetylene=acétylène
sovereign=souverain
clothe=habiller
slug=limace
aerosol=aérosol
gourd=potiron
attractive=affriolant
imagine=imaginer
gird=boucler
town=localité
superb=grandiose
baroque=baroque
bedbug=punaise
unmarried=célibataire
girl=fille
affable=affable
decrease=abaisser
flutter=conter fleurette
surmise=conjecturer
eradicate=arracher
museum=musée
germinate=germer
trumpet=trompette
bobbin=bobine
abdominal=abdominal
clothing=vêtements
trifle=babiole
migrate=voyager au loin
next=après
crocodile=crocodile
blind=aveugle
import=importer
occupy=occuper
string=défiler
submit=soumettre
affluent=affluent
nearly=presque
feldspar=feldspath
summit=bout
perfume=parfumer
button=bouton
conclusion=résultat
typist=dactylographe
not=ne ... pas
hurriedly=à la hâte
impose=contraindre
mammal=mammifère
now=eh bien
statement=déclaration
rite=rite
news=actualités
severity=austérité
delivery=remise
pinch=pincer
rack=arack
election=choix
green=vert
race=s'élancer
conquer=conquérir
complexion=teint
barometer=baromètre
greet=accueillir
war=guerre
way=chemin
grey=gris
wax=cire
sensation=sentiment
what=quoi
droop=pendre
pitiful=malheureux
risk=aventurer
window=fenêtre
athletics=athlétisme
flame=flamber
rise=surgir
container=bac
play=jouer
sorcerer=sorcier
subsidy=subvention
quickly=rapidement
raft=radeau
attentive=attentif
decide=décider
enchanter=sorcier
nearby=à
when=quand
modest=modeste
copulation=accouplement
fan=souffler sur
crush=foule
alpaca=alpaga
far=loin
abruptly=abruptement
prostitute=prostituer
electron=électron
fat=épais
catch=s'allumer
plan=dessein
metre=mètre
give=faire cadeau
counsel=avocat
aster=aster
liver=foie
double=double
erecting=montage
contention=assertion
binocular=lunette
lofty=haut
veal=veau
banyan=banian
abase=abaisser
utilize=exploiter
completely=complètement
suit=convenir
necktie=cravate
chocolate=chocolat
bastard=bâtard
hump=bosse
study=étude
gardening=jardinage
purity=propreté
direct=diriger
futile=abortif
fever=fièvre
rivulet=ruisselet
gain=acquisition
confuse=confondre
baroness=baronne
modern=moderne
abate=s'abaisser
pantry=buffet
wed=marier
tragic=tragique
wharf=quai
physician=docteur
amass=entasser
immaterial=indifférent
dial=disque
souvenir=souvenir
quaint=curieux
comical=comique
grip=agripper
explore=examiner
grit=gravier
noteworthy=remarquable
wet=mouiller
adjutant=adjudant
strawberry=fraise
climate=climat
cosmos=cosmos
ballistics=balistique
great=accompli
yoghourt=yaourt
narcissus=narcisse
wrong=abusif
criticize=critiquer
shirt=chemise
grid=grille
pleased=content
width=ampleur
behold=voici
certain=assuré
preside=présider
board=panneau
stuff=affaires
offspring=descendance
uncouple=détacher
whim=caprice
monkey=singe
arrest=arrêter
widow=veuve
abnegate=agir avec abnégation
eleventh=onzième
section=domaine
constantly=continuellement
nut=écrou
retirement=pension
whip=battre
rumor=réputation
mustard=moutarde
protocol=compte‐rendu
overflow=déborder
whale=baleine
provoke=agacer
threaten=gronder
licence=licence
rain=pleuvoir
cellar=cave
hunt=chasser
intrigue=intriguer
tangle=imbroglio
visible=apparant
gruesome=abject
alkaline=alcalin
rail=rail
tranquil=calme
hysteria=hystérie
plea=argument
inner=intérieur
strait=détroit
voyage=voyage
market=bazar
keen=actif
autodidact=autodidacte
outside=en dehors de
overhaul=dépasser
alpine=alpestre
effect=effet
keep=continuer
cruise=croiser
eagle=aigle
elementary=primaire
yoghurt=yaourt
topic=actualité
solemn=solennel
inhale=inspirer
skate=patin
perceive=s'apercevoir
sugar=sucre
option=alternative
who=que
weigh=peser
acute=aigu
politics=politique
game=jeu
handbook=guide
volley=flot
contribute=contribuer
faith=foi
why=pourquoi
remark=remarque
mystical=mystique
alone=seul
candidate=candidat
wig=perruque
parallel=parallèle
cashier=trésorier
dialogue=dialogue
inert=inerte
frontage=front
peanut=arachide
diet=diète
win=gagner
lawyer=avocat
begonia=bégonia
breach=brèche
soccer=foot
butter=beurre
chromium=chrome
granule=grain
handful=poignée
rebate=rabais
electric=électrique
stimulus=incitation
forswear=abjurer
gall=amer
regiment=régiment
sycamore=érable
ballast=ballast
diminish=s'abaisser
shine=briller
surpass=dépasser
oyster=huître
sorcery=charme
stagnate=stagner
various=divers
attention=attention
visit=visiter
rake=râteler
brimstone=soufre
sponger=parasite
storming=assaut
fig=figue
revue=revue
gaol=prison
greeting=salut
plough=labourer
thankless=ingrat
bring=amener
fin=nageoire
sauce=sauce
brink=bord
amulet=amulette
fir=sapin
mutiny=révolte
aversion=antipathie
fit=adapter
rand=rand
robot=robot
fix=adapter
husk=coque
colonial=colonial
bartender=barman
honest=honnête
pension=pension
rank=grade
ablaze=ardant
waggon=wagon
addition=addition
neglect=dédaigner
ad=annonce
carve=buriner
gang=bande
grow=devenir
sure=assuré
vein=veine
lynx=lynx
shrink=se racornir
veil=voiler
brinjal=aubergine
ah=ah
league=lieue
peach=pêche
textile=textile
ordinarily=ordinairement
an=un
former=précédent
panic=panique
extend=ampleur
manger=auge
fold=plier
as=comme
stewardess=hôtesse de l'air
at=à
yonder=là
cuckoo=coucou
peace=paix
apocryphal=apocryphe
folk=peuple
brother=frère
hurt=blesser
endlessly=infiniment
prove=démontrer
labourer=ouvrier
brothel=bordel
admire=admirer
tomato=tomate
virus=virus
aerate=aérer
blaspheme=blasphémer
pickle=affreux jojo
search=recherche
cadaver=cadavre
fool=sot
insurer=assureur
sudden=soudain
by=à
whom=auquel
relinquish=abandonner
trickery=artifice
cardboard=carton
scarcely=à peine
panel=lambris
foot=patte
tooth=dent
charge=accusation
alternate=alterner
mythical=mythique
cypres=cyprès
breathe=respirer
flu=grippe
food=nourriture
actor=acteur
tropical=tropical
fly=voler
plunge=plonger
skeptical=sceptique
zipper=fermeture à glissière
debauchery=noce
seemly=convenable
interview=entrevue
maestro=maestro
naive=naïf
essential=essentiel
gape=badauder
clarify=développer
furnace=cuisinière
insignia=insigne
ditch=fossé
stairs=escalier
grub=abattre
language=langue
do=construire
thunder=retenir
woe=aïe
observe=agir selon
armour=armure
furnish=fournir
manageable=conciliant
snare=piège
acclimate=s'acclimater
vend=vendre
woo=faire la cour
garment=habit
nutty=aromatique
rare=rare
warning=recommandation
exclude=dispenser
heating=chauffage
workbench=établi
enlighten=illuminer
needy=vide
perturb=brouiller
deduct=prélever
which=que
image=image
ribbon=ruban
mainland=continent
downstairs=dessous
fourteen=quatorze
acolyte=adepte
affirm=assurer
elemental=primaire
profound=profond
marble=marbre
never=jamais
phantom=apparition
knife=couteau
lyre=lyre
piece=contingent
temptation=tentation
aspiration=souhait
burst=crever
carry=porter
elephant=éléphant
necessity=nécessité
fog=brouillard
frame=cadre
salon=salon
debauch=bamboucher
halcyon=martin‐pêcheur
origin=origine
for=durant
mistaken=abusif
fox=renard
clasp=agrafer
overture=ouverture
hover=planer
random=accidentel
perhaps=peut‐être
subterfuge=artifice
alert=actif
plot=intrigue
rate=proportion
sanction=sanction
deduce=déduire
skill=adresse
oak=chêne
proverb=proverbe
trouble=problème
divide=séparer
prosperity=prospérité
class=classe
contrary=contradictoire
oar=aviron
stevedore=arrimeur
go=aller
syrup=sirop
conserve=conserver
layman=laïc
rhythm=rythme
tease=agacer
fork=fourchette
form=former
management=administration
publish=éditer
rasp=râper
affray=bagarre
cylinder=cylindre
renew=reconduire
he=il
assign=adjuger
promotion=année
withdraw=décéder
feather=plume
lapsed=caduc
very=bien
practice=appliquer
taskmaster=bailli
congress=congrès
divine=divin
speechless=muet
abhor=abhorrer
astronaut=astronaute
lunatic=aliéné
agony=abois
dram=apéritif
bitterness=âcreté
else=autre
four=quatre
vessel=bac
easily=facilement
drag=tirer
if=à condition que
zinc=zinc
bathroom=piscine
burnt=brûlé
clamp=parenthèse
gawk=badauder
likely=vraisemblable
abjection=abjection
accusative=accusatif
bakery=boulangerie
issue=éditer
in=à
lower=abaisser
metal=métal
verb=verbe
audacity=audace
index=liste
it=à lui
rave=être fou
asphodel=asphodèle
fry=frire
announce=annoncer
odd=bizarre
somebody=un
lively=fin
absinth=absinthe
alteration=transformation
brittle=fragile
affinity=affinité
become=devenir
gypsy=gitan
promotor=promoteur
admonish=admonester
accrue=provenir
shallowly=rapidement
eagerness=avidité
majestic=imposant
occurrence=occasion
matrimony=mariage
settlement=colonie
whirl=battre
acetate=acétate
delegate=déléguer
literature=littérature
library=bibliothèque
sphere=sphère
digest=digérer
customary=accoutumé
peril=danger
ability=aptitude
camera=caméra
abyss=abîme
belief=conviction
centipede=myriapode
currant=groseille
delight=enchanter
actinium=actinie
vest=maillot de corps
draw=allécher
lantern=lanterne
fowl=poule
generally=en général
kingship=règne
knee=genou
slender=mince
complete=complet
compensate=compenser
conscious=conscient
fun=amusement
fur=fourrure
eyelid=paupière
pants=pantalon
bribe=corrompre
solitary=pur
while=durant
clarion=clairon
second=deuxième
that=que
edge=bord
platinum=platine
orchestra=orchestre
skirt=jupe
sufficient=suffisant
than=que
limit=limiter
me=à moi
claim=aspirer à
glaze=vernis
antique=antique
pansy=pensée
thaw=dégeler
fasten=attacher
porter=bagagiste
plum=prune
repulsive=affreux
contest=concours
author=auteur
azalea=azalée
feeling=sentiment
mistletoe=gui
my=ma
plus=plus
wrench=clef
coat=paletot
entry=inscription
license=licence
dish=met
dream=rêver éveillé
ohm=ohm
perchance=peut‐être
dyspepsia=dyspepsie
essay=thèse
noble=élevé
coal=charbon
disc=disque
plug=bougie
postpone=ajourner
algebraic=algébrique
bride=accordée
heat=ardeur
favourable=favorable
no=non
furrow=rider
potassium=potassium
hammer=marteau
student=étudiant
abundantly=abondamment
careful=prudent
seal=phoque
seam=joint
swindle=frauder
illusion=illusion
head=guider
sultry=étouffant
oil=huile
of=de
heal=guérir
reserve=commander
oh=ah
somehow=de façon ou d'autre
brick=brique
dive=plonger
heap=accumuler
sympathy=sympathie
fight=batailler
hear=entendre
rescue=sauver
roundabout=alentour
on=en avant
brief=court
keyboard=clavier
pretty=aimable
or=ou
recover=recouvrer
determine=déterminer
ow=aïe
ox=bœuf
cousin=cousine
rabbi=rabbin
whilst=durant
newness=primeur
walnut=noix
absorbent=absorbant
phoenix=phénix
selfless=affectueux
equip=équiper
maple=érable
luxury=richesse
cock=bitte
knit=tricoter
aroma=arôme
salad=salade
nation=nation
rocket=fusée
adaptation=adaptation
registered=recommandé
discipline=discipline
avaricious=avare
extremely=extrêmement
freeze=geler
province=province
clever=adroit
suspenders=bretelles
estimate=apprécier
moped=vélomoteur
bookcase=bibliothèque
drip=goutte
diploma=acte
foreword=préface
recent=frais
they=ils
choke=étouffer
orgy=orgie
thee=te
insanity=aberration
nasturtium=capucine
edit=rédiger
old=vieux
recreation=transformation
them=à eux
then=après
ancient=antique
seat=siège
node=nœud
squirrel=écureuil
vaccinate=vacciner
greenweed=genêt
adopt=adopter
wander=voyager au loin
expire=finir
twelve=douze
oppose=rouspéter
bridge=pont
device=appareil
minus=moins
scythe=faux
waistcoat=gilet
belly=abdomen
activity=activité
seed=graine
yoga=yoga
cabin=cabane
seek=chercher
seem=paraître
oppress=appuyer en écrasant
heel=talon
typhus=typhus
disturb=déranger
adore=adorer
iodine=iode
lecture=conférence
persist=persévérer
pump=pomper
so=afin de pour
caution=alerter
apart=particulier
calendar=calendrier
decision=décision
necessary=nécessaire
righteous=juste
abominable=abject
one=un
garage=garage
closet=armoire
abnegation=abnégation
puma=puma
adorn=décorer
apostrophe=apostrophe
flower=fleur
monster=clébard
connected=cohérent
single=célibataire
pull=tirer
cement=ciment
subway=métro
scourge=fléau
sect=secte
acquaint=apprendre à
atrophy=atrophie
elastic=élastique
peacock=paon
assist=aider
unfaithful=traître
to=à
partially=en partie
antibiotic=antibiotique
country=campagne
joint=articulation
monsignor=monseigneur
separate=particulier
stammer=bafouiller
reasonable=abordable
willing=volontaire
trout=truite
rules=réglement
ruler=dominateur
batiste=batiste
sincerity=sincérité
wick=mèche
excellency=seigneurie
regularly=beaucoup
awareness=connaissance
postcard=carte postale
lick=lécher
bazaar=bazar
us=à nous
coil=bobine
admixture=mélange
blueberry=myrtille
usual=accoutumé
purchaser=acheteur
alacrity=avidité
this=ceci
anarchy=anarchie
suppose=supposer
thin=maigre
remarkable=remarquable
archbishop=archevêque
brake=freiner
recess=alcôve
obscure=obscur
failure=banqueroute
forge=forger
solve=résoudre
valiant=courageux
silhouette=silhouette
know=connaître
knot=nouer
coir=chœur
region=contrée
support=accoter
yearly=annuel
deceive=tricher
drop=goutte
hoopoo=huppe
saucer=soucoupe
imprint=impression
apron=tablier
prophesy=prédire
ruffian=Apache
cold=froid
reciprocal=réciproque
vertical=vertical
gruff=maussade
gag=badinage
pure=blanc
life=vie
we=nous
quail=caille
willingly=volontiers
alcoholism=alcoolisme
bookshop=librairie
honey=miel
gap=brèche
screw=baiser
skimpy=maigre
gas=gaz
emphasize=accentuer
gay=gai
psalm=psaume
airmail=poste aérienne
ore=minerai
previous=précédent
wide=ample
regime=régime
teach=apprendre
argue=se disputer
goldfinch=chardonneret
gruel=bouillie
superior=dominant
bladder=bulle
succeed=abouter
location=déstination
smock=blouse longue
dame=demoiselle noble
truculent=bagarreur
turnip=navet
accessory=accessoire
inbred=inné
kilometre=kilomètre
antenna=antenne
torment=tourmenter
arnica=arnica
fruitful=fruitier
none=nul
type=dactylographier
ye=vous
beyond=plus loin
cone=pomme de pin
helm=gouvernail
cutlet=côtelette
practise=exercer
problem=problème
hazard=hasard
terms=condition
connection=ligue
proof=preuve
abandoned=abandonné
presence=présence
laurel=laurier
phase=phase
method=méthode
slanting=oblique
wife=épouse
conclude=se résoudre à
come=provenir
leather=cuir
push=pousser
comb=peigner
exist=exister
fabric=textile
exact=exact
parlour=salon
argon=argon
lift=lever
belch=roter
force=faire accepter
alligator=alligator
autonomic=autonome
caprice=caprice
south=austral
north=nord
neglectful=négligent
pelvis=bassin
slander=calomnier
out=dehors
barbel=barbeau
confess=avouer
ghost=apparition
noon=midi
saturate=saturer
get=acquérir
dark=foncé
course=piste
witty=fin
barber=barbier
copy=copier
mediation=intermédaire
power=puissance
precise=net
beeswax=cire d'abeilles
dare=aventurer
sensible=prudent
pleasantly=agréablement
coop=poulailler
precious=rare
stutter=bafouiller
cook=cuire
sell=vendre
coffin=cercueil
suspect=se méfier
abide=attendre
brain=cerveau
thou=tu
disciples=adhérents
help=aider
depth=profondeur
massive=massif
seaside=bord
mingle=mélanger
braid=natter
aggro=agression
self=même
chorus=chœur
asset=acquisition
owe=avoir une dette
minimum=minimum
date=datte
magic=magie
archduchy=archiduché
blot=tache
dress=panser
snail=escargot
cobra=cobra
reveal=publier
data=matériau
hostel=auberge
owl=chouette
corn=maïs
garret=mansarde
onion=oignon
own=posséder
sound=sonner
harbor=port
drum=tambour
vibrate=vibrer
cork=liège
translate=traduire
drug=remède
impetus=transport
barrier=barrière
pavilion=pavillon
create=créer
blow=bataille
massage=masser
curious=curieux
proud=altier
like=comme
maxim=sentence
brace=parenthèse
pamper=choyer
earthquake=séisme
brisk=actif
plutonium=plutonium
prestige=gloire
cord=corde
core=centre
ending=bout
porthole=lucarne
addressee=destinataire
midwife=accoucheuse
anatomical=anatomique
crease=froisser
embassy=ambassade
ground=fond
visitor=visiteur
quash=abîmer
send=adresser
expenses=dépense
concrete=béton
note=billet
everybody=chacun
abridge=limiter
purpose=but
regret=regretter
hearty=cordial
line=ligne
exile=banni
link=monter
snake=serpent
snowdrop=perce‐neige
scale=échelle
hero=héros
scald=échauder
recovery=salut
aggrandize=accroître
chaplain=aumônier
security=sécurité
omnibus=autobus
buck=bouquin
organize=organiser
hearth=foyer
abstinence=abstention
station=gare
saucepan=casserole
continual=continuel
herb=herbe
herd=bande
limb=membre
nose=nez
shrill=perçant
factory=usine
oats=avoine
cost=coûter
obtuse=obtus
will=testament
confidence=foi
lime=chaux
dictator=dictateur
smoke=fumer
arbitrary=arbitraire
follow=agir selon
benzene=benzène
fertilizer=engrais
magical=magique
daddy=papa
subversion=abattage
astute=avisé
oath=serment
lily=lis
challenge=contester
dignity=dignité
roasted=grillé
intend=avoir pour but
wild=sauvage
platter=met
adjectival=adjectif
anthem=hymne
almanac=almanach
flicker=scintiller
govern=gouverner
analyse=analyser
spacious=ample
resemble=rejoindre
your=ta
remote=loin
without=sans
youth=ado
befog=brouiller
kettle=chaudron
these=ceci
twins=jumeaux
hiccup=avoir le hoquet
afflict=affliger
virgin=vierge
unsocial=antisocial
flapper=adolescente
calculate=calculer
authorize=autoriser
prison=prison
sister=sœur
audience=audience
thus=ensuite
barracks=caserne
possess=posséder
neutral=neutre
baker=boulanger
analysis=analyse
brownie=gnome
lion=lion
journalist=journaliste
windpipe=trachée
clutch=agripper
sender=envoyeur
gladiolus=glaïeul
grope=tâter
asparagus=asperge
dawn=aurore
pigeonhole=domaine
wing=aile
much=beaucoup
wine=vin
wind=vent
humble=humble
chapter=chapitre
chirp=gazouiller
commodity=article
eraser=gomme
flight=fuite
harbour=port
cloakroom=vestiaire
carriage=wagon
defence=défense
obedient=docile
achieve=acquérir
ahead=auparavant
anybody=un
buttock=fesse
misery=misère
yellow=jaune
tribunal=tribunal
plausible=vraisamblable
weekly=chaque semaine
cider=cidre
hearsay=réputation
parsley=persil
alkali=alcali
lira=lire
merciful=sensible
sharpen=affiler
committee=comité
kernel=centre
anode=anode
stingy=avare
excavate=abattre
plentiful=abondant
gnu=gnou
wipe=effacer
subtle=fin
photograph=photographier
impartial=neutre
overwhelm=abreuver
suite=clique
blue=bleu
adage=proverbe
god=dieu
yours=vôtre
adopted=adoptif
novel=nouveau
discuss=débattre
standard=drapeau
acceptable=acceptable
correct=corriger
reader=lecteur
imitate=copier
deadly=meurtrier
snorter=apéritif
wish=désirer
pad=bloc
wise=raisonnable
ambition=ambition
exceed=dépasser
enlarge=accroître
pal=camarade
area=aire
murder=assassiner
pat=taper
vicious=méchant
lace=dentelle
invitation=invitation
virginal=vierge
aviator=aviateur
paw=jambe
memento=souvenir
pay=payer
tractable=conciliant
earthen=terrestre
enormous=immense
list=liste
acetous=acide
strange=étranger
conforming=conforme
lack=défaut
toast=griller
wire=fil
tails=habit
revise=réviser
success=prospérité
vowel=voyelle
authority=autorité
creature=créature
child=enfant
regional=local
young=jeune
avenge=venger
paparazzo=paparazzo
parterre=parterre
gasoline=essence
interface=interface
lenient=indulgent
remove=ôter
wisdom=intelligence
pear=poire
peal=sonner
psychology=psychologie
fanatical=fanatique
wrestle=lutter
treasure=cassette
peat=tourbe
sugary=doucereux
live=demeurer
audacious=audacieux
twine=natter
mobile=mobile
perform=paraître
groin=aine
peak=bout
portrait=portrait
rhythmic=rythmé
with=à
acidity=acidité
chariot=char
complaint=accusation
service=office religieux
coffee=café
there=voici
ethos=ambiance
lady=demoiselle noble
analyst=analyste
ulcer=ulcère
magazine=gazette
wade=marcher dans l'eau
inject=injecter
placard=afficher
pocket=poche
freeway=autoroute
anoint=enduire
copious=abondant
channel=canal
inception=début
barque=barque
entire=entier
approach=aborder
pea=pois
wrist=poignet
braces=bretelles
hooter=avertisseur
mule=mulet
milliner=modiste
peg=apéritif
concise=concis
camel=chameau
railing=balustrade
thesis=thèse
bump=bosse
ordain=destiner
per=à
write=écrire
pet=choyer
sneer=ricaner
wage=appointements
period=période
amorphous=amorphe
proceed=procéder
aria=air de musique
bulb=ampoule
understand=comprendre
birth=naissance
dismiss=licencier
abysmal=affreux
agate=agate
slowly=lentement
heaven=ciel
ever=jadis
loving=amoureux
unhappy=malheureux
even=plat
install=construire
strongly=fortement
dishevel=ébouriffer
erotic=érotique
indication=augure
bulk=ampleur
bull=taureau
despair=désespérer
champion=champion
gum=gencive
gun=fusil
hundred=cent
wait=attendre
queen=dame
guy=individu
restrict=limiter
instant=instant
buoy=balise
mason=maçon
archangel=archange
peep=gazouiller
native=autochtone
surly=maussade
entree=hors‐d'œuvre
wail=se lamenter
costly=cher
persecute=poursuivre
debit=débit
accolade=accolade
robust=robuste
raven=corbeau
heading=intitulé
strontium=strontium
peel=dépouiller
pyjamas=pyjama
goblet=coupe
agave=agave
bayonet=baïonnette
denounce=accuser
kingfisher=martin‐pêcheur
verge=accotement
phi=horreur
snifter=apéritif
framework=cadre
befit=être décent
tide=marée
prohibit=interdire
acetone=acétone
expressway=autoroute
almost=presque
arrow=flêche
equally=de même
reign=commandement
infirm=infirme
aeroplane=aéroplane
agronomics=agriculture
manner=manière
parapet=balustrade
foresee=prévoir
sustained=continuel
pie=pâté
associate=s'accoupler
harmful=nuisible
earthly=terrestre
pig=cochon
kidney=rein
aphorism=aphorisme
wake=réveiller
pin=épingle
charity=aumône
pip=grain
pit=fossé
mineral=minéral
stock=stock
beneath=sous
terror=terreur
heroin=héroïne
void=vide
basil=basilic
swap=échanger
fondle=caresser
swan=cygne
heroic=héroïque
splinter=écharde
basin=bol
tick=tique
affected=affecté
chick=poussin
army=armée
hygienic=hygiénique
annul=abroger
tempt=tenter
snow=neiger
agape=agape
basic=basique
lake=lac
twist=tordre
udder=pis
absolve=absoudre
boulder=rocher
interment=enterrement
unclean=sale
locate=placer
nuance=nuance
unite=accoupler
abdomen=abdomen
bush=arbrisseau
fruit=fruit
bearded=barbu
prisoner=prisonnier
accost=aborder
acquittal=réglement
cause=faire
despise=dédaigner
mush=bouillie
indulge=être indulgent
unity=unité
agitated=agité
beetle=scarabée
murk=obscurité
pursue=poursuivre
twentieth=vingtième
vulgar=trivial
design=dessin
cadre=cadre
land=aborder
goblin=gnome
victim=victime
skull=crâne
department=domaine
cholera=choléra
hysterical=hystérique
lane=ruelle
pastor=curé
allude=faire allusion
measurable=prévisible
burn=brûler
garlic=ail
imposing=imposant
chief=dominant
accord=être d'accord
aircraft=aéronef
automatic=automatique
bonbon=bonbon
doubtful=incertain
lamp=lampe
vigour=activité
despite=malgré
groan=gémir
conduct=guider
obey=obéir
botch=gâcher
plunder=piller
velvet=velours
lamb=agneau
tidy=ordonner
burr=bardane
formerly=auparavant
wall=mur
walk=marcher
burp=roter
lame=boiteux
policeman=agent
quietly=paisiblement
apparatus=appareil
nipple=mamelon
marry=marier
decay=abaissement
discussion=discussion
acorn=gland
grieve=affliger
incidental=auxiliaire
theocracy=théocratie
fracture=fracture
lessen=abaisser
rubidium=rubidium
rendezvous=rencontre
meeting=séance
welcome=recevoir solennellement
marsh=marais
drift=dériver
chaos=chaos
separately=particulièrement
daffodil=narcisse
absorption=absorption
abundant=abondant
want=désir
almond=amande
overshoe=galoche
forecast=prédire
mute=muet
gunpowder=poudre à canon
uncover=découvrir
cormorant=cormoran
recognize=croire
bamboo=bambou
induce=conclure
abnormal=aberrant
wane=diminuer
wand=badine
difference=différence
reality=réalité
shrewd=avisé
must=devoir
offend=insulter
circle=cercle
resign=abdiquer
bathe=baigner
diligent=appliqué
banisters=balustrade
overalls=blouse longue
aluminum=aluminium
chase=amener à
prize=prix
accident=accident
antifreeze=antigel
anyway=de façon ou d'autre
ravine=abîme
found=fonder
routine=routine
excuse=dispenser
lectern=pupitre
pot=pot
chasm=abîme
defense=défense
blackbird=merle
knight=chevalier
canal=canal
lark=alouette
escape=échapper
funny=amusant
retention=garde
fiancee=accordée
receive=accepter
yam=igname
batik=batiker
binoculars=jumelles
felspar=feldspath
sandal=sandale
refresh=rafraîchir
intimate=intime
entirely=complètement
entrust=charger
arse=anus
religion=religion
diagram=figure
charm=amulette
tragedy=tragédie
arbor=tonnelle
amuck=amok
baptistery=baptistère
bison=bison
anthracite=anthracite
evoke=rappeler
preface=introduction
friendship=amitié
till=caisse
attend=soigner
smith=forgeron
allegoric=allégorique
shovel=pelleter
salivate=baver
tilt=incliner
secure=attacher
wasp=guêpe
canopy=baldaquin
fatty=gras
ham=jambon
incite=agiter
school=école
continue=continuer
things=affaires
tile=carreau
beryllium=béryllium
avenue=allée
hat=chapeau
immense=énorme
realize=comprendre
brush=brosse
hay=foin
perish=périr
unlock=ouvrir
arum=arum
definite=définitif
last=précédent
adapt=adapter
lass=fille
wash=laver
weight=balance
cheerful=gai
solicitor=avocat
allegedly=il paraît que
dissemble=agir en hypocrite
prepay=affranchir
warn=alerter
warm=cordial
guilty=coupable
measure=mesurer
proximity=voisinage
chalk=craie
maritime=marin
receipt=quittance
wart=verrue
rattle=claquer
swim=nager
basement=cave
radon=radon
quibble=chicaner
curved=courbe
thicken=grossir
impossible=impossible
diskette=disquette
effort=démarche
tint=nuance
ozone=ozone
wave=onde
anything=quelque chose
yesterday=hier
weapon=arme
courageous=courageux
tipsy=gris
hooker=fille
prudent=prudent
autocrat=autocrate
pheasant=faisan
numeral=chiffre
wonted=accoutumé
baritone=baryton
early=hâtif
cower=être accroupi
disease=infirmité
yen=yen
incitement=incitation
loathe=abhorrer
yes=bien
airfield=aérodrome
lowering=abaissement
yet=encore
engineer=ingénieur
endorse=virer
cuddly=tendre
wager=parier
alike=pareil
genius=génie
wages=appointements
colour=couleur
laud=glorifier
seclude=isoler
delightful=délicieux
typical=représentatif
aorta=aorta
time=fois
addled=idiot
pub=abreuvoir
buzz=bourdonner
quotation=citation
wither=se faner
tray=plateau
shadow=ombre
happy=heureux
barium=baryum
infant=enfant
put=appliquer
pus=pus
hen=poulet
her=à lui
offence=agacement
carbon=carbone
unload=décharger
circus=cirque
nameless=anonyme
trap=piège
odour=odeur
tram=tramway
deprive=dépouiller
haricot=haricot
struggle=se débattre
okay=bon
torpedo=torpiller
pedal=pédale
swoon=s'évanouir
dossier=dossier
lesson=leçon
baptism=baptême
magnesium=magnésium
ambulance=ambulance
philosophy=philosophie
slope=côte
baptist=baptiste
lapse=retomber
light=allumer
passenger=passager
apparently=évidemment
nauseate=écœurer
tiny=miniscule
niche=niche
munition=munitions
acidify=acidifier
worship=adoration
lawn=batiste
valuable=cher
stubborn=obstiné
artist=artiste
formulate=formuler
indictment=accusation
tourism=tourisme
actuate=mouvoir
glorify=glorifier
emigrate=se réfugier
alien=abject
hoax=mystifier
layer=couche
smart=artificieux
triangle=triangle
rebound=rebondir
ornament=ornament
ivory=ivoire
growl=grogner
letterbox=boîte aux lettres
theme=composition
attest=attester
smash=briser
entice=détourner
barrel=fût
chain=chaîne
fiasco=échec
desire=désirer
touching=attendrissant
chair=chaise
murmur=murmurer
consistent=cohérent
lately=dernièrement
reverse=inverse
chat=babil
grandiose=grandiose
permanent=continuel
chap=individu
garden=jardin
summarize=abréger
choice=choix
travel=aller
cuddlesome=tendre
small=petit
beam=rayon
gallant=brave
peevish=maussade
beak=bec
rhino=rhinocéros
before=avant
cucumber=concombre
bead=perle
replace=mettre en place de
aviation=aviation
stomach=estomac
him=à lui
hip=hanche
listen=écouter
beguine=béguine
hit=battre
his=sa
squash=potiron
major=commandant
pussy=chatte
beat=battre
bumpy=accidenté
emphasis=emphase
interrupt=interrompre
bear=faire naître
consider=considérer
eighty=quatre‐vingts
flatter=aduler
bean=fève
group=bande
hostess=aubergiste
psyche=psychisme
croak=croasser
repeatedly=plusieurs fois
whither=où
beguinage=béguinage
lounge=salon
workshop=atelier
dampen=abreuver
guidebook=guide
resist=résister
tact=mesure
tree=arbre
history=histoire
stimulate=agacer
careless=négligent
square=droit
distrust=se méfier
soak=tremper
absolutely=absolument
anarchism=anarchisme
commute=aiguiller
sustain=accoter
soap=savon
anarchist=anarchique
condom=condom
altitude=altitude
request=demander
colony=colonie
composure=repos
alburnum=aubier
their=leur
shepherd=pasteur
percent=pourcentage
point=bout
thirteen=treize
general=général
attachment=attachement
frighten=redouter
hospital=hôpital
dimension=ampleur
nostalgia=nostalgie
anaemic=anémique
ceiling=plafond
deserve=mériter
process=procédé
anaemia=anémie
artisan=artisan
chef=chef
clear=clair
banner=drapeau
prawn=crevette
teapot=théière
encounter=rencontrer
alibi=alibi
clean=pur
chive=ciboulette
meal=farine
agrarian=agrarien
sock=chaussette
approve=approuver
mean=intermédiaire
neither=nul
baptize=baptiser
glad=joyeux
meat=viande
chew=mâcher
pedestrian=piéton
abrogation=abolition
hurry=se dépêcher
account=facture
sometime=jadis
mostly=plupart
innocent=innocent
repulse=rejeter
marguerite=marguerite
hoarse=rauque
beef=bœuf
alphabet=abc
stride=faire les cent pas
advance=s'approcher
opine=être d'avis
jeweller=bijoutier
trip=voyage
appreciate=apprécier
granny=grand‐maman
trim=garnir
yon=là
diverse=divers
beet=betterave
strict=austère
beer=bière
you=à toi
jump=sauter
knowledge=connaissance
soft=doux
geranium=géranium
happen=devenir
iris=iris
sofa=canapé
festival=fête
loyal=droit
scoundrel=canaille
active=actif
alchemy=alchimie
apotheosis=apothéose
court=faire la cour
venture=oser entreprendre
population=population
enthusiasm=enthousiasme
route=chemin
flexible=souple
gaunt=angulaire
agile=agile
bulky=ample
corpse=cadavre
hoe=houe
wisely=sagement
organ=organe
hog=cochon
mirror=miroir
shiver=trembler
hop=houblon
soil=sol
bottle=bouteille
vanity=futilité
rouse=exciter
how=comment
spark=étincelle
affix=affixe
radiator=radiateur
comet=comète
farming=agriculture
assembly=accumulation
spare=être indulgent
chin=menton
etching=eau‐forte
piston=piston
tail=queue
gulden=florin
pistol=pistolet
assemble=réunir
lentil=lentille
march=marcher
vulture=vautour
mutter=murmurer
answer=correspondre à
meet=réunir
publicize=propager
series=série
ablative=ablatif
cultivate=cultiver
wildebeest=gnou
wizard=sorcier
purse=porte‐monnaie
represent=représenter
compete=concourir
celebrity=star
dispatch=déposer
apathetic=apathique
inborn=inné
sometimes=parfois
listener=auditeur
inclined=enclin
promise=assurer
fief=seigneurie
dandelion=pissenlit
hold=tenir
tale=récit
atoll=atoll
lithium=lithium
shipwreck=naufrage
absurd=absurde
modesty=modestie
waffle=gaufre
prior=précédent
blockade=se mettre en travers
porpoise=marsouin
rubber=caoutchouc
coupe=compartiment
trait=trait
talk=parler
tall=haut
reply=correspondre à
spaceman=astronaute
vault=voûte
train=clique
baron=baron
apostolic=apostolique
dolphin=dauphin
planet=planète
count=comte
creep=ramper
trough=auge
prospectus=prospectus
scholar=savant
motorway=autoroute
take=accepter
vision=vision
accompany=accompagner
immediate=immédiat
blame=gronder
relatively=relativement
rigour=austérité
abet=agiter
confusion=désordre
hinge=charnière
some=une certaine quantité
blank=blanc
beginning=début
landlord=aubergiste
session=session
additional=additionnel
buffoon=arlequin
accretion=accroissement
deceived=déçu
trot=trotter
alpha=alpha
conceited=frivole
bland=doucereux
microbe=microbe
tank=citerne
just=juste
notice=affiche
sole=pur
vapour=vapeur
winged=blessé
patrolman=gendarme
grandson=petit‐fils
holy=sacré
idiot=idiot
home=domicile
pious=pieux
armoury=arsenal
hole=fossé
hypnosis=hypnose
postage=port
print=impression
tame=dresser
adjoin=aboutir
although=quoique
hub=moyeu
material=matériel
francium=francium
hogweed=berce
bovine=bœuf
comforter=sucette
hue=nuance
iron=fer
peculiar=drôle
whinny=hennir
president=président
explain=expliquer
basket=corbeille
hum=bourdonner
envy=envier
staple=parenthèse
hut=cabane
royalty=règne
hope=espérer
soon=bientôt
tablet=liste
hook=agrafe
melt=dégeler
tape=bande
bend=courber
rheumatism=rhumatisme
action=activité
stadium=étape
belt=ceinture
boutique=boutique
revolver=revolver
dowry=don
chop=hacher
creak=grincer
cream=crème
protest=protester
sensitive=sensible
hood=Apache
bell=clochette
operative=ouvrier
hoof=sabot
vacant=vague
heavy=lourd
afford=permettre
impression=effet
appease=abattre
tattler=babillard
shield=enseigne
acanthus=acanthe
anatomy=anatomie
bazooka=bazooka
ostrich=autruche
anvil=enclume
unpleasant=maussade
deliver=fournir
phenomenon=phénomène
writhe=se débattre
summer=été
eight=huit
trailer=baladeuse
abbey=abbaye
file=dossier
greasy=gras
intrepid=audacieux
member=adhérent
tart=acerbe
accredit=accréditer
disapprove=repousser
nourish=alimenter
together=ensemble
illness=infirmité
grease=graisse
faucet=robinet
nematode=nématode
shanty=baraque
lengthen=allonger
within=à
anarchic=anarchique
bent=courbe
strike=battre
smack=faire du bruit avec les lèvres
subdue=soumettre
health=santé
amber=ambre
heresy=hérésie
torch=torche
positive=positif
autarky=autarcie
favourite=favori
menu=carte
maize=maïs
adulteress=adultère
septic=septique
rustle=sussurer
soot=suie
machine=machine
refugee=réfugié
able=apte à
hops=houblon
evening=soir
mend=rapiécer
workplace=atelier
return=rente
topical=actuel
concerned=concerné
conscience=conscience
banquet=banqueter
decently=convenablement
integer=entier
serve=être de service
cassette=cassette
cough=tousser
ballade=ballade
drown=noyer
blade=lame
radio=radio
smile=sourire
heath=bruyère
geographic=géographique
solution=réponse d'un problème
fine=beau
find=discerner
opponent=adversaire
host=aubergiste
accelerate=accélerer
citizen=citoyen
confiscate=confisquer
barge=barge
illustrate=illustrer
occur=arriver
pleasant=agréable
scuba=scaphandre autonome
difficult=difficile
definitive=définitif
sluice=écluse
film=film
sort=acabit
fill=compléter
dentist=dentiste
heart=cœur
painter=peintre
millimetre=millimètre
forget=oublier
professor=professeur
convenient=commode
horn=corne
task=devoir
infer=conclure
troupe=troupe
true=vrai
adolescent=adolescent
header=rubrique
tactics=tactique
sore=ulcère
valley=vallée
position=position
curtail=abréger
present=actuel
glow=brûler
curtain=rideau
adorable=adorable
since=à partir de
sentiment=sentiment
soup=potage
asbestos=asbeste
soul=âme
abundance=abondance
dangerous=dangereux
quivering=frisson
mess=bouillie
morphia=morphine
sour=acerbe
delete=effacer
kimono=kimono
speciality=domaine
transform=résoudre
hour=heure
advise=conseiller
mysticism=mysticisme
agitate=agiter
mesh=maille
certainly=assurément
gorilla=gorille
pigmy=pygmée
rooster=coq
edelweiss=edelweiss
brandish=agiter
renter=locataire
geographer=géographe
master=apprendre à fond
concerning=concernant
attraction=appât
beech=hêtre
regulation=règle
complicate=compliquer
puzzle=énigme
tidbit=friandise
evident=évident
mere=pur
writer=auteur
hypocrite=hypocrite
fence=barrière
villa=villa
annoy=agacer
profess=avouer
shawl=châle
glue=coller
miscarry=avorter
scream=clameur
solder=braser
quotes=guillemets
autogenous=autogène
cover=couvrir
theatre=théâtre
firm=ferme
reflect=réfléchir
outfit=complet
procession=procession
massacre=massacrer
fire=partir
bungle=gâcher
proton=proton
tartness=aigreur
taxi=taxi
zap=zapper
howl=hurler
tiger=tigre
something=quelque chose
intention=dessein
whorehouse=bordel
pointed=pointu
rude=impoli
bulldozer=bulldozer
funeral=enterrement
except=dispenser
impulse=impulsion
asymmetric=asymétrique
foreigner=étranger
religious=religieux
shower=douche
manure=engrais
poppy=coquelicot
jewel=bijou
fist=poing
vomit=rejeter
outline=silhouette
adieu=adieu
anagram=anagramme
fade=pâlir
excess=excès
admonition=observation
honour=honorer
rebellion=révolte
invade=envahir
reaction=réaction
propeller=hélice
accordance=accord
dogma=dogme
bevy=bande
trousers=pantalon
adhesion=adhésion
people=gens
prognosis=prognostic
lagoon=lagune
actually=en réalité
peninsula=péninsule
evolve=évoluer
face=affronter
abandon=abdiquer
afraid=timide
fish=pêcher
invite=inviter
adverse=contradictoire
operation=opération
bulletin=bulletin
junction=accouplement
circumvent=circuler
crumble=froisser
announcer=speaker
daydream=rêver éveillé
instinct=instinct
cannon=canon
reputation=réputation
ice=crème glacée
shrug=hausser les épaules
inside=à
verbatim=à proprement parler
mainly=principalement
melancholy=mélancolique
shrub=arbrisseau
motorcycle=moto
graveyard=cimetière
beseech=implorer
handlebars=gouvernail
engrave=graver
restrain=réprimer
awkward=maladroit
adhesive=adhésif
five=cinq
ruin=abaisser
mutton=mouton
lyceum=lycée
celebrate=célébrer
admirable=admirable
acidness=acidité
please=s'il vous plaît
zilch=zéro
collection=bande
abut=aboutir
stanchion=pieu
hunger=faim
wheeziness=asthme
archduke=archiduc
squad=compagnie
attune=adapter
laboratory=laboratoire
inspect=inspecter
campaign=campagne
salvage=salut
abdication=abdication
conflict=conflit
boulevard=boulevard
loudly=à haute voix
rough=brut
squat=être accroupi
lawsuit=procès
father=père
barrister=avocat
rule=commandement
amateur=amateur
purge=affinier
condemn=condamner
commerce=commerce
girdle=ceinture
resentment=rancune
poem=poème
gulf=abîme
poet=poète
wonder=s'étonner
sneeze=éternuer
every=chaque
guiltless=innocent
mansion=immeuble
shave=raser
nickel=nickel
accustom=avoir coutume
bandit=bandit
madness=aberration
propaganda=propagande
sulphur=soufre
again=de nouveau
refuge=refuge
certainty=assurance
commend=glorifier
spine=colonne vertébrale
indeed=d'abord
guitar=guitare
mosquito=moustique
vicar=curé
artificial=affecté
parasite=parasite
removal=déménagement
employ=embaucher
sturdy=robuste
prefix=préfixe
binding=bande
rung=marche
fable=fable
autobus=autobus
during=durant
fair=bazar
balcony=balcon
consist=consister
prick=bitte
charitable=sensible
compatible=correspondant
grammar=grammaire
rump=derrière
price=prix
safety=sécurité
dresser=commode
opportune=commode
pincers=pinces
sharpness=acuité
decoration=décor
dependent=subordonné
eggplant=aubergine
transitive=transitif
profession=profession
arise=se soulever
birch=bouleau
templet=modèle
agree=être d'accord
resistance=résistance
underneath=dessous
itself=même
enjoyable=agréable
emperor=empereur
aniline=aniline
breakfast=petit déjeuner
valve=abattant
balalaika=balalaïka
favorite=favori
bumblebee=bourdon
distress=attrister
steel=acier
hillside=côte
steep=abrupt
thumb=pouce
seize=agripper
church=église
classical=classique
nettle=ortie
privilege=privilège
sheriff=shérif
substitute=mettre en place de
foreign=étranger
uniform=uniforme
amplitude=amplitude
fall=s'abattre
boiler=chaudron
meager=maigre
moreover=d'ailleurs
mysterious=mystérieux
scatter=disperser
violate=attenter
rubble=abattis
steer=diriger
event=événement
buddy=camarade
finger=doigt
springtime=printemps
agency=agence
coupon=coupon
railroad=chemin de fer
multitude=amas
innate=inné
siege=siège
nobleness=grandeur
abstract=abstrait
agenda=agenda
nice=agréable
jawbone=mâchoire
comma=virgule
appearance=air
liquid=flot
culture=culture
anonymous=anonyme
unroll=développer
fisherman=pêcheur
first=premier
girder=poutre
abbot=abbé
bizarre=bizarre
perfect=accompli
prefer=aimer mieux
preferably=mieux
minority=minorité
pole=pieu
graceful=gracieux
stringent=rigoureux
tight=strict
space=espace
chamber=chambre
frog=grenouille
arrange=accommoder
nephew=neveu
from=de
publicity=propagande
depart=partir
viking=Viking
accordion=accordéon
bench=banc
drawers=caleçon
bottom=fond
ill=malade
finished=prêt
rhyme=rime
spade=creuser
disciple=disciple
autocratic=autocratique
collision=choc
arbiter=arbitre
fortress=bastille
arthritis=arthrite
airlift=pont aérien
dignified=digne
anapaest=anapeste
fame=renommée
acerbic=acerbe
bosom=poitrine
pond=étang
repair=réformer
death=mort
noiseless=silencieux
steak=bifteck
trite=banal
arrival=arrivage
ashtray=cendrier
deportment=procédé
steal=d'acier
adornment=ornament
advice=avis
mercury=mercure
frequent=fréquenter
powder=poudre
error=erreur
imp=lutin
aggregate=agrégat
network=filet
forsake=abandonner
jealous=jaloux
seemingly=apparemment
rust=rouille
trace=empreinte
petal=pétale
paper=document
public=public
soiled=sale
pomp=pompe
endeavour=se démener
steam=vapeur
zoo=zoo
track=piste
value=mérite
procure=procurer
catarrh=rhume
centennial=siècle
fortune=fortune
quantity=quantité
repay=rembourser
ink=encre
inn=auberge
resources=moyen
pestle=pistil
rush=se dépêcher
demolish=abaisser
expensive=cher
worthless=nul
hinny=bardot
gush=jaillir
trade=commerce
currently=actuellement
round=reprise
ambassador=ambassadrice
growth=accroissement
invoice=facture
titmouse=mésange
comic=comique
weave=tisser
carrot=carotte
pope=pape
fare=aller
bicycle=bécane
accuracy=exactitude
psychiatry=psychiatrie
resolution=motion
building=construction
geological=géologique
properly=convenablement
score=adapter
fart=péter
precipice=abîme
quote=citer
acuity=acuité
poor=malheureux
farm=bien
rag=chiffon
terrain=terrain
grief=abattement
ram=bélier
navigate=naviguer
rap=rapper
appendix=appendice
rat=rat
fairly=relativement
pool=s'accoupler
raw=brut
prude=bégueule
ray=rayon
adapted=adapté
sprinkle=joncher
acrobatics=acrobaties
airport=aéroport
snore=ronfler
hurried=hâtif
courtyard=cour
promenade=promenade
skyjacker=pirate de l'air
institute=institut
endure=continuer
breakable=fragile
poster=affiche
southern=austral
fate=destination
cultured=cultivé
throat=gorge
unkind=maussade
insistence=impulsion
pork=porc
maneuver=intrigue
dollar=dollar
begrudge=ménager
dual=double
vocabulary=dictionnaire
retire=se retirer
aspect=air
dexterous=adroit
aggressive=agressif
barbarity=barbarie
close=fermer
supporters=adhérents
chemistry=chimie
federation=fédération
instalment=acompte
nigger=bougnoul
signify=signifier
swine=cochon
swing=balancer
fast=jeûner
invasion=invasion
anchovy=anchois
leisurely=paisiblement
hunchback=bossu
dissect=sectionner
spin=filler la laine
robber=ravisseur
cistern=citerne
shallow=superficiel
congestion=afflux
scout=reconnaissance
spit=cracher
register=enregistrer
fleet=flotte
nine=neuf
ace=as
couple=couple
saddle=selle
telltale=babillard
annoyance=désolation
rural=rural
acclaim=acclamer
concord=accord
acid=acerbe
red=rouge
act=agir
helper=adjoint
post=afficher
negligence=négligence
duck=canard
shortage=défaut
blush=rougir
tiresome=ennuyeux
finish=confectionner
coping=arête
moustache=moustache
swift=prompt
add=additionner
liquidate=liquider
accede=adhérer
abstemious=sobre
pose=agir avec affectation
its=leur
remedy=guérir
arsenic=arsenic
consent=admettre
helpless=abandonné
article=article
respect=respecter
shelf=étagère
retreat=décéder
barbarism=barbarisme
ache=douleur
notary=notaire
parachute=parachute
mutual=réciproque
port=port
shell=conque
therefore=aussi
adjustment=adaptation
exchange=central
panther=panthère
hesitate=barguigner
ballpoint=stylo à bille
rifle=fusil
aurochs=aurochs
income=produit
trust=se fier
joining=accouplement
wallflower=giroflée des murailles
production=production
morals=morale
choose=adopter
paste=agglutiner
overtake=passer
beehive=ruche
dues=cotisation
prevent=empêcher
behave=se conduire
previously=auparavant
piglet=cochonnet
colonel=colonel
magpie=pie
abstention=abstention
wadding=ouate
embrace=embrasser
identify=identifier
assailant=attaquant
nitrogen=azote
ghastly=désagréable
pour=verser
aglow=ardant
artesian=artésien
message=message
ivy=lierre
jest=badiner
aquarium=aquarium
modify=modifier
exempt=dispenser
reservoir=bol
age=âge
crab=crabe
crossways=en largeur
township=hameau
ouch=aïe
motorist=automobiliste
movie=film
sickle=serpe
aconite=aconit
tendency=aptitude
arithmetic=arithmétique
shah=schah
yearn=aspirer
amphibian=amphibie
rid=débarrasser
boar=verrat
number=nombre
shorten=abréger
tungsten=tungstène
punish=punir
swish=sussurer
acme=apogée
rim=bord
decline=diminuer
property=bien
rip=déchirer
debris=abattis
aha=ah
delicacy=friandise
rhombus=barbue
viewpoint=point de vue
antithesis=antithèse
scuffle=bataille
embroider=broder
nothing=le néant
whistle=siffler
handle=tâter
isolation=abandon
snappy=perçant
script=scénario
hairy=velu
exit=issue
melody=mélodie
mailbox=boîte aux lettres
system=système
hairs=cheveux
spot=déstination
silver=argent
aid=adjoint
lukewarm=tiède
vixen=renarde
barony=baronnie
laddie=garçon
micrometre=micromètre
serfdom=servage
other=autre
aim=avoir pour but
city=cité
uncle=oncle
retain=réprimer
drastic=énergique
epoch=époque
air=air
courage=abattage
local=local
defeat=abattre
aerodrome=aérodrome
bubble=bulle
yield=abandonner
firstly=au commencement
vacation=vacances
assertion=assertion
speak=parler
terrace=terrasse
cathedral=cathédrale
sacred=sacré
advertiser=messager
tender=adjudication
infected=septique
blushing=rouge
vapor=vapeur
meditate=méditer
prototype=prototype
boat=barque
recollect=retenir
acne=acné
powerful=puissant
future=futur
cite=citer
wench=fille
amoeba=amibe
spades=piqûre
atom=atome
moan=gémir
movement=mouvement
royal=royal
shed=abri
eelworm=anguillule
glove=gant
precision=exactitude
sardine=sardine
body=corps
referee=arbitre
correspond=correspondre
spur=inciter
mode=manière
rear=arrière‐garde
cage=cage
acrimony=acuité
insect=insecte
buffet=bar
presume=aspirer à
ale=bière
buffer=pare‐chocs
qualify=qualifier
pregnant=enceinte
all=tout
always=en tous temps
border=lisière
abhorrence=abomination
imposter=charlatan
read=lire
already=déjà
syndicate=syndicat
touch=toucher
adhere=concorder
admission=abord
clock=horloge
real=effectif
rumour=réputation
alas=malheureusement
unit=unité
cafe=café
hybrid=hybride
monthly=mensuel
mock=bafouer
motoring=automobilisme
uranium=uranium
collect=collectionner
badly=mal
adherents=adhérents
facilitate=faciliter
outing=excursion
rob=piller
rod=barre
dumb=muet
roe=chevreuil
accession=acquisition
quiver=trembler
favour=grâce
telegraph=télégraphe
disappoint=tromper
rebellious=rebelle
basalt=basalte
and=et
rot=pourrir
today=aujourd'hui
dump=verser
row=ramer
chaperon=accompagnatrice
chemist=apothicaire
abroad=à l'étranger
fifteen=quinze
undermine=saper
radical=radical
ant=fourmi
contingent=éventuel
any=un
apiary=rucher
bristly=ébouriffé
minute=minute
analogy=analogie
acerbity=acuité
ladder=échelle
swirl=tourbilloner
untie=détacher
earmark=destiner
acre=acre
until=à
hypothesis=hypothèse
dull=abêtir
reversed=inverse
profuse=abondant
reason=cause
accurate=ponctuel
thought=pensée
octopus=poulpe
taste=goût
privet=troène
ship=expédier
anywhere=quelque part
erect=fonder
innkeeper=aubergiste
antipode=antipode
altar=autel
naught=zéro
cake=gâteau
ape=singe
jam=confiture
protein=protéine
annual=annuel
gentle=doux
testify=attester
boil=bouillir
lightning=éclair
jaw=mâchoire
reef=écueil
tummy=ventre
devoted=affectueux
margin=marge
musquash=ondatra
naif=naïf
dung=excrément
nail=clouer
reed=roseau
refine=raffiner
aspen=tremble
reek=embaumer
testament=testament
demand=abattement
mount=adapter
toilet=cabinet
acquiesce=se résigner
turkey=dindon
atomic=atomique
grade=degré
letter=lettre
aureole=auréole
triangular=triangulaire
tasty=savoureux
accuse=accuser
hymn=hymne
accentuate=accentuer
autocracy=autocratie
frequently=beaucoup
devil=diable
algebra=algèbre
odor=odeur
acquire=acquérir
morphine=morphine
tactic=tactique
worth=mérite
fertile=fécond
sheaf=gerbe
notion=notion
arc=arc
are=are
tractor=tracteur
grace=charme
patience=patience
penis=pénis
where=où
abstruse=mystérieux
arm=armer
popular=populaire
caper=gambader
stitch=coudre
art=art
vice=vice
acclivity=côte
airship=dirigeable
esteem=apprécier
shear=couper avec des ciseaux
alga=algue
miserly=avare
abattoir=abattoir
suppress=réprimer
broker=représentant
wrinkle=rider
beige=beige
call=nommer
aerolite=aérolithe
calm=calme
ownership=propriété
calf=veau
ash=cendre
ask=demander
supervise=surveiller
relations=proches
serene=serein
rub=frotter
ass=âne
through=complètement
becoming=convenable
engagement=accordailles
castle=château
strength=force
officer=officier
arrack=arack
run=fonctionner
rum=rhum
bomb=bombe
debate=débat
extinguish=éteindre
mother=mère
mouse=souris
view=air
preach=prêcher
defraud=frauder
herring=hareng
primrose=primevère
subjugate=soumettre
donate=faire cadeau
dust=poussière
palace=palais
worry=avoir soin de
overlay=recouvrir
mole=taupe
mold=modeler
telephone=téléphoner
bold=audacieux
admiral=amiral
delicious=savoureux
worse=pire
agitation=agitation
sunbeam=rayon de soleil
everywhere=partout
name=nom
crow=corbeau
bolt=verrouiller
cane=bâton
hornet=taon
mourn=regretter
abatement=abaissement
whiskey=whisky
shoo=amener à
truce=trêve
shop=boutique
distance=distance
mood=ambiance
myrrh=myrrhe
abolish=abolir
absence=absence
abstain=s'abstenir
attract=allécher
book=livre
truck=camion
show=manifester
cautious=prudent
astronomic=astronomique
disappear=disparaître
renounce=abjurer
crouch=être accroupi
malicious=méchant
perplexity=embarras
defend=défendre
arrive=arriver
street=rue
stupidly=stupidement
mantle=manteau
nape=nuque
boot=botte
analogous=analogue
shoe=chaussure
itch=démanger
rancour=rancune
tonsil=amygdale
abbreviate=abréger
foreward=en avant
adherent=adepte
learned=cultivé
introduce=offrir
substance=substance
varnish=vernis
bone=os
monk=moine
bond=lien
suddenly=soudainement
target=but
obstruct=barrer
mouth=bouche
grind=moudre
acrobatic=acrobatique
bony=osseux
nervous=nerveux
absorbing=passionnant
stranger=inconnu
aquatic=aquatique
cape=cap
rye=seigle
delicate=délicat
leader=conseiller
fancy=imaginer
trump=atout
yard=cour
rebel=se révolter
commotion=agitation
froth=battre
ammonia=ammoniaque
contralto=alto
rent=loyer
cart=char
steppe=steppe
amnesty=amnistie
axe=hache
aubade=aubade
cast=fondre
anxious=agité
piano=piano
slice=balafre
auditory=auditorium
frost=gel
larva=larve
broad=ample
princess=princesse
incline=incliner
truly=en réalité
case=affaire
generation=génération
oppressive=étouffant
subscriber=abonné
gene=gène
eighteen=dix‐huit
violet=violet
sideral=astral
trunk=coffre
wares=marchandise
adulterer=adultère
carp=carpe
moon=lune
omen=augure
duchy=duché
moor=attacher
refined=délicat
buttocks=cul
style=style
waist=taille
flesh=chair
jungle=jungle
alms=aumône
hairpiece=perruque
card=carte
grill=grille
care=avoir soin de
belladonna=belladone
assault=assaillir
cherry=cerise
damage=avarie
boss=maître
guard=préserver
adorer=adoratrice
heighten=aggraver
pattern=schéma
settle=se résoudre à
exercise=exercer
harsh=acerbe
fireplace=cheminée
labour=accoucher
vehicle=bagnole
madam=madame
scrape=effacer en grattant
admirer=admiratrice
bleak=désagréable
kiln=cuisinière
kilo=kilogramme
cushion=coussin
freedom=liberté
scold=admonester
adulterous=adultère
basilica=basilique
glorious=fameux
physics=physique
seldom=rarement
plateau=plateau
bleat=bêler
comrade=camarade
aptitude=aptitude
protect=préserver
vile=abject
daisy=pâquerette
scorpion=scorpion
stress=accentuer
more=davantage
display=parader
courgette=courgette
gnat=cousin
aloe=aloès
kill=abattre
gnaw=ronger
bore=forer
nomination=liste
acrobat=acrobate
sallow=pâle
apostate=apostat
worshipper=adoratrice
astringent=astringent
disorder=désordre
aggravate=agacer
spurt=jaillir
corkscrew=tire‐bouchon
disquiet=brouiller
upholster=rembourrer
colossal=énorme
persevere=persévérer
shut=fermer
luck=destinée
mature=fait
spiked=pointu
masturbate=se masturber
simple=pur
wrapper=banderole
influence=influer
cloud=brouiller
afire=ardant
nave=moyeu
percentage=pourcentage
talent=aptitude
vine=vignoble
rogue=canaille
violin=violon
cave=grotte
crisis=crise
king=dame
moth=mite
kind=affable
addiction=lubie
tumult=bagarre
germ=microbe
shatter=briser
glamour=gloire
both=les deux
important=considérable
most=extrêmement
moss=mousse
resin=résine
transfer=passer
affection=affection
daily=journalier
nerve=nerf
affluence=richesse
diversion=amusement
fervour=ferveur
job=ouvrage
speedwell=véronique
autopsy=autopsie
daughter=fille
omit=omettre
courteous=courtois
cloth=linge
erroneous=abusif
jog=faire du jogging
mommy=maman
ascertain=constater
lighthouse=phare
cavalier=chevalier
affecting=attendrissant
awaken=réveiller
insert=introduire
captain=capitaine
forbid=interdire
bowl=bassin
malaria=malaria
adjective=adjectif
tortoise=tortue
joy=allégresse
patient=patient
reject=rejeter
sad=affligé
clown=clown
compliment=compliment
miracle=miracle
sheet=feuille
profit=bénéfice
thresh=battre
rinse=rincer
sheep=mouton
subvert=saper
rest=débris
amount=nombre
move=affecter
original=inédit
sap=jus
adherence=attachement
album=album
nylon=nylon
yawn=bâiller
saw=scier
also=aussi
sandwich=sandwich
say=dire
enough=suffisant
increase=accroître
chatterbox=babillard
cougar=puma
kingdom=royaume
differ=différer
spread=étendre
afternoon=après‐midi
puppet=guignol
educated=cultivé
favor=grâce
midget=nain
crowbar=levier
depression=crise
front=front
affiliate=adhérer
customer=client
plane=aéroplane
equivalent=équivalent
stupid=bébête
bad=mal
christen=baptiser
angina=angine
asterisk=astérisque
wedge=cale
alimony=pension alimentaire
facile=facile
mussel=moule
assemblage=réunion
testicle=testicule
kiss=baiser
ban=anathème
mackerel=maquereau
offer=offrir
bar=barrer
suffer=endurer
dynamite=dynamite
bat=chauve‐souris
squint=loucher
fluid=flot
bay=aboyer
cinema=cinéma
rubbish=absurdité
pamphlet=brochure
adjourn=ajourner
afterwards=après
hippo=hippopotame
hazardous=périlleux
personal=personnel
artery=artère
haggle=marchander
alum=alun
crucifix=crucifix
plastic=plastique
delay=ajourner
globe=globe
defiantly=en dépit de
plant=planter
sonorous=sonore
drive=amener à
plank=panneau
sponge=éponge
deal=dispenser
strong=fort
abuse=insulter
insulate=isoler
scheme=projet
affect=affecter
deaf=sourd
dainty=aimable
onerous=lourd
abasement=abaissement
drain=drainer
sea=marin
amputate=amputer
amuse=amuser
isolate=isoler
sailor=marin
see=rencontrer
servant=domestique
civil=civil
national=national
indicate=désigner
wheat=froment
dear=cher
sixty=soixante
contain=contenir
set=appareil
sew=coudre
punctuate=parsemer
sex=sexe
column=colonne
medicine=remède
portent=augure
procedure=procédé
jingle=tinter
sample=spécimen
battle=bataille
admiration=admiration
vise=visa
visa=visa
archaism=archaïsme
rivet=rivet
somewhat=une certaine quantité
craziness=aberration
earnest=sérieux
river=fleuve
jug=cruche
kite=milan
spider=araignée
bed=planche
widower=veuf
bee=abeille
larder=buffet
beauty=beauté
panties=caleçon
beg=mendier
precede=avancer
deck=pont
lupine=lupine
stroll=promenade
bet=parier
detention=arrestation
parish=paroisse
contact=s'aboucher avec
discharge=partir
useless=inutile
geologist=géologue
laborer=ouvrier
digit=chiffre
detachment=commando
plaster=revêtir
plash=barboter
suspicious=méfiant
complain=porter plainte
zeal=ferveur
anxiety=anxiété
she=elle
adjust=adapter
abbatial=abbatial
debt=dette
party=adhérents
fluff=duvet
little=petit
deer=cerf
however=cependant
deep=profond
humane=charitable
ballerina=ballerine
shy=timide
forgive=excuser
goose=oie
deem=croire
compel=imposer
capable=apte à
depress=abattre
parade=parader
riddle=énigme
salute=accueillir
lemon=citron
decor=décor
advertence=attention
aunt=tante
await=attendre
client=acheteur
sin=commetre yne faute
sip=absorber
decoy=attirer
larch=mélèze
sir=monsieur
lump=boule
conversion=transformation
sit=couver
over=au‐dessus de
tenderness=tendresse
brilliant=luisant
practical=réel
six=six
eyebrow=sourcil
oven=cuisinière
shackle=chaîne
steering=direction
obviously=évidemment
tyrant=tyran
weasel=belette
corpulent=épais
football=foot
dinner=déjeuner
stroke=apoplexie
trajectory=trajectoire
breed=élever
descry=s'apercevoir
appraise=apprécier
implicate=empêtrer
pyramid=pyramide
cheque=chèque
farmer=fermier
advertency=attention
realm=puissance
avoid=éviter
lull=bercer
bid=offrir
fresh=frais
prompt=ponctuel
tunnel=tunnel
peasant=paysan
big=grand
corridor=corridor
expert=experimenté
atheism=athéisme
crowd=amas
thankful=reconnaissant
repose=se reposer
invoke=invoquer
ladybug=coccinelle
chanson=chanson
sick=malade
bit=fragment
atheist=athée
slaughter=abattre
ski=ski
thanks=remerciement
knead=pétrir
corner=accaparer
beside=à
majority=majorité
model=modèle
join=adhérer
costume=complet
autistic=autistique
crown=couronner
reduce=abaisser
sentence=phrase
sky=ciel
eggfruit=aubergine
large=grand
surface=comble
baton=bâton
director=directeur
satisfied=content
vain=abortif
tomorrow=demain
ordinary=ordinaire
foolish=abracadabrant
youngster=ado
harmonious=harmonieux
drink=s'enivrer
bough=branche
lung=poumon
edging=bord
operate=fonctionner
verdict=sentence
defy=provoquer
hello=allô
begin=aborder
parrot=perroquet
bacterium=bactérie
sizable=considérable
template=modèle
judgement=arrêt
paragraph=alinéa
sly=artificieux
alive=vivant
proportion=proportion
crystal=cristal
prophet=prophète
neighbour=voisin
plate=met
abhorrent=abject
bankruptcy=banqueroute
cycle=bécane
aura=aura
lure=attirer
leech=sangsue
world=monde
inquiry=enquête
astronomer=astronome
dissolve=résoudre
prejudice=parti‐pris
angle=angle
tradition=tradition
everything=tout
congregate=réunir
programme=programme
composing=montage
table=liste
amidst=au milieu de
countryman=paysan
unsound=véreux
bread=pain
side=auxiliaire
disembark=débarquer
thorn=épine
break=pause
change=transformation
restaurant=restaurant
cupboard=armoire
comfort=confort
joke=badiner
bacon=lard
likewise=aussi
century=siècle
hide=fourrure
punishment=peine
antisocial=antisocial
discovery=découverte
candle=bougie
report=apprendre à
shuffle=mélanger
married=mariée
keepsake=souvenir
pessimism=pessimisme
constant=continuel
congruent=correspondant
lament=se lamenter
vertebra=vertèbre
lute=luth
several=plusieurs
sign=augure
cotton=coton
squire=chaperonner
angel=ange
office=bureau
suffix=suffixe
plaza=esplanade
sift=tamiser
high=haut
son=fils
split=fendre
immerse=immerger
helix=hélice
lust=passion
squirt=projeter un liquide
champagne=champagne
pessimist=pessimiste
sow=coche
undress=déshabiller
different=différent
directly=debout
petroleum=pétrole
kneel=s'agenouiller
discretion=précaution
obliging=complaisant
unthankful=ingrat
level=plat
beget=engendrer
lever=lever
preserve=préserver
establish=fonder
boa=boa
confide=confier
proclaim=proclamer
trollop=roulure
spy=espion
parents=parents
birthday=anniversaire
balustrade=balustrade
behind=derrière
excrement=excrément
candy=friandise
pricey=précieux
recipe=recette
drugstore=pharmacie
box=boxer
mental=intellectuel
bow=arc
decent=convenable
boy=garçon
pseudonym=pseudonyme
handicraft=métier
switch=badine
total=total
niece=nièce
adrenaline=adrénaline
upstairs=dessus
savage=sauvage
consumer=consommateur
sentry=sentinelle
zebra=zèbre
console=consoler
chance=accidentel
nature=caractère
social=social
wheel=roue
cross=croiser
control=commandement
gladness=allégresse
drill=forer
apricot=abricot
decrepit=caduc
emmet=fourmi
earth=butter
quarrel=dispute
amen=ainsi soit‐il
pulse=pouls
heroine=héroïne
overthrow=abattre
mould=modeler
stumble=achopper
cunning=artificieux
stool=banquette
elbow=coude
spanner=clef
stoop=pencher
vary=différer
coherent=cohérent
upper=supérieur
delta=delta
dwelling=demeure
musket=mousquet
paint=couleur
vase=pot
xenon=xénon
transgress=commetre yne faute
animate=animer
somewhere=quelque part
injure=abîmer
scene=scène
bra=soutien‐gorge
exert=pratiquer
scandal=agacement
heroism=héroïsme
sideboard=armoire
geography=géographie
hinder=déranger
horrible=abject
friend=amie
scent=odeur
betrothal=accordailles
injury=blessure
adjunct=addition
mushroom=champignon
altruistic=altruiste
alcohol=alcool
alchemist=alchimiste
angelica=angélique
deny=nier
miserable=lamentable
pleasure=plaisir
subtract=retrancher
asthma=asthme
hurricane=ouragan
remaining=autre
accept=accepter
glory=gloire
morning=matin
horse=cheval
secondary=accessoire
badge=insigne
mission=mission
mystic=mystique
sty=écurie
autumn=automnal
motor=moteur
access=accès
hind=biche
hemorrhoid=hémorrhoïde
sum=montant
recite=réciter
stallion=cheval entier
sun=ensoleillé
gelding=cheval hongre
bookstore=librairie
current=actuel
fjord=fiord
democrat=démocrate
secretary=secrétaire
audit=surveiller
crippled=infirme
cactus=cactus
fancier=amateur
copper=cuivre
civilian=civil
corrugate=onduler
mouldy=moisi
bewitch=ensorceler
key=touche
silk=soyeux
silent=silencieux
antimony=antimoine
sill=seuil
storm=donner l'assaut
manager=administrateur
orator=orateur
slipper=pantoufle
launch=lancer
skylight=lucarne
asphalt=asphalter
store=boutique
stork=cigogne
quell=étouffer
confirm=confirmer
hill=butter
stopper=bouchon
bug=punaise
cloak=manteau
cricket=grillon
rearguard=arrière‐garde
gallop=galoper
fourth=quatrième
vast=ample
intervene=intervenir
story=étage
but=mais
bus=autobus
symbol=symbole
stoke=chauffer
declare=déclarer
dislike=antipathie
buy=acheter
cognac=cognac
express=répandre
topicality=actualité
advocate=avocat
confine=limiter
quest=recherche
zero=zéro
horizontal=horizontal
instantly=aussitôt
apache=Apache
burial=enterrement
luggage=bagage
beaver=castor
generate=engendrer
passion=ardeur
sector=secteur
extreme=extrême
anecdotal=anecdotique
tapestry=tapisserie
athlete=athlète
clergyman=abbé
sink=forer
degree=degré
dismal=banal
astronomy=astronomie
drizzle=bruine
ranch=bien
tube=chambreàair
especially=surtout
ocean=océan
altruism=altruisme
dismay=abasourdir
carpet=tapis
desk=pupitre
hint=faire allusion
sing=chanter
altruist=altruiste
hire=embaucher
foxglove=digitale
idea=idée
donkey=âne
monument=monument
infantry=infanterie
inventory=recensement
manoeuvre=intriger
defecate=aller à la selle
anonymity=anonymat
assent=affirmer
turnover=opération de caisse
fluorine=fluor
lovely=agréable
normal=standard
brutal=maussade
figure=chiffre
airway=route aérienne
transmit=adresser
socialism=socialisme
weaken=abattre
apathy=abattement
consulate=consulat
bye=adieu
stone=pierre
voltage=tension
flute=flûte
zest=vigueur
periodical=gazette
specially=particulièrement
leaflet=brochure
gentleman=monsieur
punctual=ponctuel
advertise=annoncer
sack=licencier
humility=modestie
reach=aboutir
fringe=bord
hack=hacher
hiss=siffler
wreathe=natter
credential=lettre de créance
road=chemin
review=compte‐rendu
warlock=sorcier
dreadful=affreux
sight=air
weather=temps
roar=gronder
tighten=serrer
timber=bois
nobody=nul
roam=voyager au loin
traveller=voyageur
between=au milieu de
guide=diriger
raspberry=framboise
spectacle=spectacle
antibody=anticorps
collar=col
goal=but
natural=naturel
overhead=aérien
bouillon=bouillon
goat=chèvre
banker=banquier
lettuce=laitue
putrefy=pourrir
beggar=mendiant
navel=nombril
dahlia=dahlia
seventeen=dix‐sept
following=adhérents
motto=devise
aggressor=attaquant
flag=drapeau
intestine=intestin
wear=porter
aurora=aurore
derive=dériver
gazette=gazette
weak=faible
rock=balancer
impress=en imposer à
flax=lin
feature=trait
lean=accoter
assert=affirmer
flat=appartement
recall=retenir
leap=sauter
place=adapter
regular=régulier
coddle=choyer
monkshood=aconit
valise=valise
dispute=se disputer
blouse=blouse
pelican=pélican
tired=fatigué
tremble=trembler
gymnastics=gymnastique
bramble=mûre sauvage
aggression=agression
suggest=désigner
leaf=feuille
urinate=faire pipi
optician=opticien
inhabitant=habitant
lead=guider
fraction=fraction
token=preuve
filter=filtrer
expect=attendre
cease=cesser
emotion=émotion
soothe=abattre
robe=robe
elements=abc
spectator=spectateur
cornflower=barbeau
behaviour=procédé
scarce=insuffisant
abjuration=abjuration
apology=apologie
haddock=aiglefin
obsess=obséder
argument=argument
easel=établi
passage=corridor
adequate=adéquate
utter=répandre
sausage=andouille
plait=natter
dozen=douzaine
tillage=agriculture
assets=actif
armchair=fauteuil
divert=distraire
twelfth=douzième
hygiene=hygiène
offal=abats
plain=plaine
only=ne ... que
should=devoir
sage=sauge
drake=canard mâle
verse=strophe
furious=furieux
indistinct=confu
notebook=cahier
tap=forer
proboscis=trompe
individual=individu
tar=goudron
briefcase=collection à consulter
salmon=saumon
accepted=accepté
bouquet=bouquet
ugly=mauvais
tax=imposer
towards=à
barbaric=barbare
broach=forer
person=personnage
testimony=témoignage
safe=à l'abri
cadger=parasite
departure=départ
fragile=fragile
herself=même
arsenal=arsenal
handshake=poignée de main
tuna=thon
week=semaine
sail=voile
obtainable=accessible
distinct=clair
flee=échapper
gigantic=formidable
kilobyte=kilobyte
geology=géologie
flea=puce
hedge=haie
tune=adapter
weep=pleurer
aware=conscient
dragonfly=libellule
hair=cheveu
cap=casquette
filthy=sale
participle=participe
car=auto
marriage=mariage
ready=prêt
cat=mégère
stove=cuisinière
alarm=alarmer
caw=croasser
weed=sarcler
sparrow=moineau
village=localité
mealies=maïs
smooth=plat
pacifier=sucette
balloon=aérostat
overcoat=paletot
motion=motion
satisfy=contenter
earthworm=lombric
match=allumette
adaptor=adapteur
hail=grêle
accent=accentuer
leek=ail
clothes=vêtements
really=en réalité
lorry=camion
tabulation=liste
granite=granit
category=catégorie
rival=concourir
